정류소명,정류소아이디(ID),승차건수(총합계),하차건수(총합계),승차건수(카드),하차건수(카드),승차건수(현금),일평균 승하차건수
(구)국제여객터미널,35051,99,1671,21,1671,78,59
(구)국제여객터미널,35052,2374,44,2312,44,62,80
(주)경동세라믹스,89146,315,39,312,39,3,11
(주)경인양행앞,42096,973,814,957,814,16,59
(주)경인양행앞,42097,1452,3459,1424,3459,28,163
(주)대한특수금속,39050,1249,75,1246,75,3,44
(주)두남,39135,137,28,136,28,1,5
(주)세모입구(린나이코리아),37585,1382,1613,1382,1613,0,99
(주)세모입구(린나이코리아),40893,240,649,240,649,0,29
(주)스킨이데아,89388,163,138,162,138,1,10
(주)스킨이데아,89389,726,15,686,15,40,24
(주)씨피엔텍,39133,559,3559,558,3559,1,137
(주)씨피엔텍,39134,2358,381,2356,381,2,91
(주)창원,39029,3447,2911,3444,2911,3,211
(주)창원,39030,4114,3224,4114,3224,0,244
(주)하나금속,39124,9,22,9,22,0,1
17사단.다임메가타운,40895,1997,4540,1980,4540,17,217
17사단입구,40832,27,536,17,536,10,18
2001아울렛,40154,3498,5853,3460,5853,38,311
2001아울렛,40159,30061,13803,29691,13803,370,1462
2001아울렛,40162,11275,21322,11099,21322,176,1086
2001아울렛부평점,40158,5076,2654,4894,2654,182,257
2차풍림아이원,42584,45,11032,31,11032,14,369
3단지,40736,409,1758,384,1758,25,72
3단지관리사무소,40107,1998,543,1982,543,16,84
41번구종점,42174,1940,6323,1896,6323,44,275
510번차고지,36145,785,281,785,281,0,35
540번종점,39470,3560,20,3506,20,54,119
6공단사거리,37577,481,2571,476,2571,5,101
6공단입구,37442,624,1107,603,1107,21,57
6공단입구,37443,1275,1594,1231,1594,44,95
8부두,35181,302,2760,263,2760,39,102
8부두,35182,1750,4821,1685,4821,65,219
CJ인천2공장,35591,222,2944,205,2944,17,105
CJ인천2공장,35592,2235,67,2223,67,12,76
E편한세상,42453,3484,2592,3405,2592,79,202
E편한세상,42649,1330,2571,1320,2571,10,130
E편한세상,42726,2867,1402,2834,1402,33,142
GM물류센터,40568,503,1481,490,1481,13,66
GS25편의점,36142,988,2290,933,2290,55,109
GS내리주유소,44147,3,0,3,0,0,0
GS칼텍스,35168,594,59,573,59,21,21
GS칼텍스,35557,8,2406,8,2406,0,80
GS칼텍스,89220,54,121,49,121,5,5
GS칼텍스,89224,54,1710,52,1710,2,58
GS칼텍스주유소,39814,162,15,157,15,5,5
HD현대인프라코어,36081,775,1854,770,1854,5,87
HD현대인프라코어,36083,2555,1227,2518,1227,37,126
HD현대인프라코어후문,36077,45,803,10,803,35,28
HD현대인프라코어후문,36078,4220,845,4211,845,9,168
JC회관,37383,4327,4390,4251,4390,76,290
KCC아파트,42391,1430,1079,1399,1079,31,83
KG스틸,42008,2456,4466,2429,4466,27,230
KTX광명역4번출구,58057,1067,7,1067,7,0,35
KT부평지사,40381,10467,6475,10295,6475,172,564
KT부평지사,40384,6642,13023,6521,13023,121,655
KT서인천지사,42932,1596,2491,1562,2491,34,136
KT서인천지사,42933,1654,1017,1638,1017,16,89
KT송도지점,38568,518,331,501,331,17,28
KT온수분국,43523,655,315,632,315,23,32
KT인천공항지사,35095,350,66,348,66,2,13
KT인천공항지사,35109,7847,3408,7456,3408,391,375
KT인천지사,37415,6355,4656,6240,4656,115,367
KT인천지사,39319,8731,4327,8534,4327,197,435
KT중동지사,55081,844,186,839,186,5,34
KT중동지사,55082,197,1021,194,1021,3,40
LG마그나,89029,6260,1963,6243,1963,17,274
LG마그나,89264,2759,5505,2759,5505,0,275
LG물류센터,39043,316,95,316,95,0,13
LG물류센터,39044,51,435,51,435,0,16
LG아파트후문,42616,356,28,356,28,0,12
LG아파트후문,42617,4,170,4,170,0,5
LG전자(주),42297,4757,3374,4733,3374,24,271
LH1단지,35494,8634,3820,8493,3820,141,415
LH1단지,35495,4065,5764,3929,5764,136,327
LH49단지행복주택아파트,35768,538,805,534,805,4,44
LH49단지행복주택아파트,35769,1592,855,1566,855,26,81
LH7단지,35451,2763,2364,2661,2364,102,170
LH7단지,35452,2716,3107,2653,3107,63,194
LH미추홀3단지,37222,2890,6112,2729,6112,161,300
LH미추홀3단지,37635,6826,3151,6710,3151,116,332
LH웨스턴블루힐정문,89184,993,2505,981,2505,12,116
LH웨스턴블루힐정문,89185,3625,3877,3573,3877,52,250
NKG물류센터,89212,322,61,306,61,16,12
SK.GS주유소,89230,1141,1613,1140,1613,1,91
SK.GS주유소,89231,1435,1503,1431,1503,4,97
SKLPG충전사업소,35636,520,18,480,18,40,17
SKLPG충전사업소,35638,105,486,8,486,97,19
SK뷰아파트,42888,1539,5408,1497,5408,42,231
SK뷰아파트,42889,7120,1344,6831,1344,289,282
SK스카이뷰,37601,453,27515,453,27515,0,932
SK스카이뷰104동,37587,8211,65,8211,65,0,275
SK스카이뷰109동,37607,7396,128,7396,128,0,250
SK인천석유화학,42767,1246,683,1227,683,19,64
SK인천석유화학,42768,280,778,278,778,2,35
SK주유소,42956,401,318,392,318,9,23
SK주유소앞,35287,2077,115,2033,115,44,73
SK주유소앞,35539,107,2722,94,2722,13,94
SK충전소,35085,53,2906,23,2906,30,98
e편한세상 정문,38624,18443,906,18210,906,233,644
e편한세상(109동 앞),32062,780,1174,767,1174,13,65
e편한세상(109동앞),38643,1100,535,1040,535,60,54
e편한세상1차(정문),35662,630,1162,606,1162,24,59
e편한세상1차(정문),35663,1684,456,1675,456,9,71
e편한세상계양,41037,14567,3565,14452,3565,115,604
e편한세상계양,41038,5150,12969,5045,12969,105,603
e편한세상영종센텀베뉴정문,35510,966,3566,943,3566,23,151
e편한세상영종오션하임,35674,1745,735,1722,735,23,82
e편한세상영종오션하임,35761,633,1042,620,1042,13,55
e편한세상영종하늘도시,35646,363,581,362,581,1,31
e편한세상영종하늘도시,35647,195,311,192,311,3,16
gym80fitness,37081,2490,893,2429,893,61,112
가경공원,89365,873,773,859,773,14,54
가구단지사거리,37455,3418,5113,3353,5113,65,284
가구단지사거리,37456,3204,2254,3173,2254,31,181
가구전시장,42072,509,580,488,580,21,36
가구전시장,42074,662,556,656,556,6,40
가나안마을앞,43904,3,22,3,22,0,0
가나안마을앞,43905,47,2,47,2,0,1
가능포,43969,1,2,1,2,0,0
가능포,43970,2,18,2,18,0,0
가림고등학교,42078,13226,13117,12966,13117,260,878
가야,42807,511,1,498,1,13,17
가야,42808,23,1123,22,1123,1,38
가양역.우성아파트,25107,9821,7680,9790,7680,31,583
가오대입구,80033,168,355,152,355,16,17
가오대입구,80034,129,641,94,641,35,25
가원초등학교,42952,6286,4341,6213,4341,73,354
가원초등학교,89118,2578,5463,2505,5463,73,268
가재우물터,35678,6,2,6,2,0,0
가재우물터,35700,2,10,2,10,0,0
가재울사거리,42039,2262,5527,2243,5527,19,259
가재울사거리,42042,8187,4873,8112,4873,75,435
가재울역,42034,2276,2826,2270,2826,6,170
가재울역,42035,3589,2260,3530,2260,59,194
가정(루원시티)역,89050,9258,46111,9218,46111,40,1845
가정(루원시티)역,89051,56364,6578,56197,6578,167,2098
가정(루원시티)역,89075,73177,74348,72780,74348,397,4917
가정(루원시티)역,89078,83677,72034,83211,72034,466,5190
가정3동성당,42226,480,3272,473,3272,7,125
가정LH3단지정문앞,89041,18319,3722,18145,3722,174,734
가정고등학교,42200,11453,4384,11245,4384,208,527
가정고등학교,42203,3359,7615,3273,7615,86,365
가정교차로,89390,246,729,242,729,4,32
가정교차로,89391,681,3211,681,3211,0,129
가정동성당,89102,3562,3584,3450,3584,112,238
가정동성당,89105,2705,1836,2671,1836,34,151
가정보금자리,89119,1317,429,1313,429,4,58
가정보금자리,89120,41,1300,41,1300,0,44
가정여자중학교,42041,237,7364,233,7364,4,253
가정여중입구,89303,858,927,836,927,22,59
가정중앙시장역,42215,1459,1219,1424,1219,35,89
가정중앙시장역,42219,1179,2175,1155,2175,24,111
가정택지삼거리,89385,299,219,299,219,0,17
가정택지삼거리,89386,267,485,265,485,2,25
가정휴먼시아3단지,89186,1272,1567,1261,1567,11,94
가정휴먼시아3단지,89187,1968,1861,1891,1861,77,127
가좌2동행정복지센터,42073,5841,241,5808,241,33,202
가좌2동행정복지센터,42076,160,5179,144,5179,16,177
가좌3동행정복지센터,42075,12900,13927,12779,13927,121,894
가좌4동행정복지센터,42062,4843,6995,4767,6995,76,394
가좌고등학교,42060,15566,12318,15288,12318,278,929
가좌고등학교,42061,5508,8786,5408,8786,100,476
가좌공단,42526,87,10200,41,10200,46,342
가좌공단,42945,7684,25,7610,25,74,256
가좌교회,42055,3903,8383,3845,8383,58,409
가좌교회,42057,4268,4185,4185,4185,83,281
가좌녹지공원,42029,1286,3558,1271,3558,15,161
가좌녹지공원,42030,1695,1090,1684,1090,11,92
가좌농협,42066,8322,7163,8126,7163,196,516
가좌농협,42067,5979,5880,5833,5880,146,395
가좌동차고,42939,2879,516,2301,516,578,113
가좌동차고지,42522,520,1021,60,1021,460,51
가좌두산위브104동앞,42090,5316,3532,5235,3532,81,294
가좌사거리,42043,31,285,25,285,6,10
가좌사거리,42044,456,4310,434,4310,22,158
가좌진주아파트,42100,13637,27587,13405,27587,232,1374
가좌체육공원,42058,7468,1301,7416,1301,52,292
가좌초등학교,42069,4087,4701,4002,4701,85,292
가좌초등학교,42070,4777,2547,4727,2547,50,244
가좌테니스장,37454,2406,1103,2387,1103,19,116
가좌테니스장,37457,822,1448,814,1448,8,75
가좌현대아파트,42130,8269,2537,8129,2537,140,360
가좌현대아파트,42133,907,8471,898,8471,9,312
가좌홈플러스(쌍마아파트),42101,10172,7661,9871,7661,301,594
가좌홈플러스(쌍마아파트),42103,7399,11401,7104,11401,295,626
가좌환경사업소,42631,7109,3899,7025,3899,84,366
가좌환경사업소 북측,89341,173,303,173,303,0,15
가좌환경사업소북측,89342,15,271,15,271,0,9
가천대학교,38270,1119,941,1056,941,63,68
가천대학교,38284,8654,3062,8542,3062,112,390
가천대학교(노인복지회관),38269,858,988,846,988,12,61
가천의대,43237,6,48,6,48,0,1
가천의대,43897,31,5,31,5,0,1
가톨릭대,43325,3,49,3,49,0,1
가현오일뱅크,42734,49,23,46,23,3,2
가현중학교,42722,3146,2946,3076,2946,70,203
가현초교앞(루에블리아파트),89242,3369,4565,3180,4565,189,264
가현초교앞(센트럴타운아파트),89243,5316,1655,5249,1655,67,232
각곡,43602,6,105,4,105,2,3
각곡,43772,225,12,207,12,18,7
간석4거리,39538,336,394,325,394,11,24
간석4동새마을금고,39343,3380,6144,3265,6144,115,317
간석4동새마을금고,39346,3414,2460,3336,2460,78,195
간석4동행정복지센터,39403,4255,8111,4238,8111,17,412
간석4동행정복지센터,39412,5449,3071,5402,3071,47,284
간석금호어울림아파트,39334,25922,12901,25411,12901,511,1294
간석남부역,37429,3523,870,3479,870,44,146
간석남부역,37435,7256,2403,7106,2403,150,321
간석남부역,37529,1217,3009,1204,3009,13,140
간석동용광경로당,39394,1035,532,1007,532,28,52
간석래미안.자이,39333,16923,18239,16718,18239,205,1172
간석북부역,39806,3903,79,3791,79,112,132
간석북부역,39807,87,2533,61,2533,26,87
간석북부역·우성1차,39368,12399,4420,12383,4420,16,560
간석북부역·우성1차,39370,5288,10014,5260,10014,28,510
간석사거리,39413,13463,9358,13318,9358,145,760
간석사거리,39414,5098,10643,5051,10643,47,524
간석사거리,39430,2124,2605,2104,2605,20,157
간석사거리(상인천중학교),39422,12955,28987,12789,28987,166,1398
간석사거리(상인천중학교),39426,32245,19009,31984,19009,261,1708
간석시장,39434,13001,31305,12764,31305,237,1476
간석시장,39436,57334,32679,56848,32679,486,3000
간석시장,39437,15779,21525,15677,21525,102,1243
간석오거리,39460,17759,14347,17582,14347,177,1070
간석오거리,39597,4631,3509,4610,3509,21,271
간석오거리(교원공제조합),39444,36271,29432,36096,29432,175,2190
간석오거리(인천웨딩홀),39406,9104,12101,8758,12101,346,706
간석오거리(인천웨딩홀),39423,34159,20979,33750,20979,409,1837
간석오거리역(7번출구),39447,17924,33476,17786,33476,138,1713
간석오거리역(8번출구),39449,63179,74047,62954,74047,225,4574
간석지구대,39535,509,608,499,608,10,37
간석지구대,39536,518,748,512,748,6,42
간석풍림아파트,92053,548,606,538,606,10,38
간석한신더휴아파트맞은편,37447,2327,493,2327,493,0,94
간재울초등학교,42347,6175,3930,5922,3930,253,336
간촌,43504,37,40,34,40,3,2
간촌,43518,49,29,43,29,6,2
갈산대동아파트,40550,260,806,260,806,0,35
갈산동아아파트,40567,1617,1771,1605,1771,12,112
갈산동입구,40622,24,4276,24,4276,0,143
갈산동천주교회,40652,856,4686,822,4686,34,184
갈산동천주교회맞은편,40650,5197,4588,5130,4588,67,326
갈산두산아파트,40544,4082,5881,4021,5881,61,332
갈산사거리,40631,2928,4257,2848,4257,80,239
갈산사거리,40634,3358,5114,3296,5114,62,282
갈산새마을금고,40635,8564,2000,8495,2000,69,352
갈산시장,40628,6667,5803,6619,5803,48,415
갈산시장.갈산도서관,40629,2248,7114,2221,7114,27,312
갈산역,40601,35751,12544,35577,12544,174,1609
갈산역,40602,10551,43602,10467,43602,84,1805
갈산역(1번출구),40604,24164,7182,23983,7182,181,1044
갈산역(부평4공단)4번출구,40606,6661,18397,6603,18397,58,835
갈산주공1단지,40578,3182,2136,3133,2136,49,177
갈산주공1단지105동,40813,7710,2883,7647,2883,63,353
갈산주공2단지,40562,401,1106,401,1106,0,50
갈산주공2단지,40577,4132,7396,4028,7396,104,384
갈산태화아파트,40542,529,1263,518,1263,11,59
갈산태화아파트,40664,4905,858,4808,858,97,192
갈산태화아파트,40666,279,1603,263,1603,16,62
갈산태화아파트,40667,676,2589,671,2589,5,108
갈월초등학교,40531,111,1121,111,1121,0,41
갈현경로당,41491,40,333,40,333,0,12
갈현경로당앞,41607,276,48,271,48,5,10
갈현교,41608,142,35,135,35,7,5
갈현교,41609,142,122,2,122,140,8
갈현교입구,41492,438,35,431,35,7,15
갈현교입구,41617,1,150,1,150,0,5
갈현동마을,41351,1056,727,1039,727,17,59
갈현동마을,41352,300,1509,297,1509,3,60
갑곶돈대.강화전쟁박물관,43365,14,11,14,11,0,0
갑곶돈대.강화전쟁박물관,43728,5,23,5,23,0,0
갑곶돈대입구,43367,6,7,5,7,1,0
갑곶돈대입구,43726,12,7,12,7,0,0
갑륭초교,43374,0,4,0,4,0,0
갑륭초교,43724,8,185,8,185,0,6
갑문,35125,22,483,18,483,4,16
갑문,35504,185,18,182,18,3,6
강남시장,42172,20961,13994,20416,13994,545,1165
강남시장,42173,12375,11244,12122,11244,253,787
강남역.역삼세무서,23287,1033,1143,1033,1143,0,72
강남역도시에빛,31076,2566,6643,2566,6643,0,306
강남역서초현대타워앞,31016,49097,32305,49024,32305,73,2713
강남중교,43213,146,20,142,20,4,5
강남중교,43278,18,161,18,161,0,5
강서중학교,43660,2,82,0,82,2,2
강서중학교,43898,154,10,142,10,12,5
강인여객,40020,1117,1612,1070,1612,47,90
강인여객,40022,1259,894,1248,894,11,71
강화갯벌장어,43633,4,3,4,3,0,0
강화갯벌장어,43671,0,3,0,3,0,0
강화경찰서,43209,239,21,219,21,20,8
강화경찰서,43624,8,220,4,220,4,7
강화고등학교,43564,6,16,6,16,0,0
강화고등학교,43761,164,153,164,153,0,10
강화군 행복센터,43055,126,1569,121,1569,5,56
강화군 행복센터,43056,1,238,1,238,0,7
강화군노인문화센터,90373,0,18,0,18,0,0
강화군노인문화센터,90374,1,0,1,0,0,0
강화군청,43065,3494,736,3267,736,227,141
강화군청,43108,718,2572,694,2572,24,109
강화루지.강남상회,43150,203,84,195,84,8,9
강화루지.강남상회,43250,94,227,93,227,1,10
강화마니산,43001,36,40,35,40,1,2
강화마니산,43002,474,134,453,134,21,20
강화문화원.종합전시관,43097,2,51,2,51,0,1
강화문화원.종합전시관,43098,30,522,29,522,1,18
강화병원,43088,25,1242,20,1242,5,42
강화병원,43089,987,71,976,71,11,35
강화산단,90123,0,13,0,13,0,0
강화산단입구,90096,0,16,0,16,0,0
강화산단입구,90097,17,0,17,0,0,0
강화산성서문,43080,3,14,3,14,0,0
강화산성서문,43081,59,77,59,77,0,4
강화서문,43063,535,447,516,447,19,32
강화서문,43064,447,432,410,432,37,29
강화수양관앞,43467,73,27,73,27,0,3
강화수양관앞,43732,3,29,2,29,1,1
강화슈퍼,43066,554,1057,546,1057,8,53
강화슈퍼,43068,1535,272,1399,272,136,60
강화실버케어스앞,43975,35,181,35,181,0,7
강화실버케어스앞,43976,75,72,75,72,0,4
강화아시아드BMX경기장,43799,1,65,0,65,1,2
강화여자중학교,90334,0,50,0,50,0,1
강화역사박물관(고인돌),43601,275,24,261,24,14,9
강화역사박물관(고인돌),43670,19,352,19,352,0,12
강화장례식장,43918,1446,84,1362,84,84,51
강화장례식장,43946,33,1822,27,1822,6,61
강화중학교,43207,26,24,25,24,1,1
강화중학교,43623,11,21,10,21,1,1
강화터미널,43096,49095,986,46236,986,2859,1669
개항동 어울터,35197,9808,2069,9505,2069,303,395
개항동 어울터,35198,2439,9031,2377,9031,62,382
개화2치안센터,25023,42,1827,38,1827,4,62
개화2치안센터,25024,2508,40,2498,40,10,84
개화역1번출구.개화검문소,25030,161,7265,159,7265,2,247
개화역1번출구.개화검문소,25031,2737,254,2696,254,41,99
개화역광역환승센터,25182,1421,2109,1418,2109,3,117
갤러리84입구,35666,49,8,45,8,4,1
갤러리84입구,35667,10,52,9,52,1,2
갯벌슈퍼,43410,2,11,2,11,0,0
갯벌슈퍼,43513,10,9,10,9,0,0
거북시장,42132,14281,12160,13835,12160,446,881
거북시장,42136,13210,11609,12873,11609,337,827
거산정공.(주)록키,39137,1324,1691,1324,1691,0,100
거잠포선착장,35302,114,379,114,379,0,16
거잠포선착장,35303,381,127,380,127,1,16
거잠포회센터,35588,112,46,95,46,17,5
건설기술교육원,39353,6656,11149,6631,11149,25,593
건설기술교육원,39354,4953,3822,4934,3822,19,292
건영아파트,38069,16179,39808,16034,39808,145,1866
건일아파트,43015,381,179,363,179,18,18
건일아파트,43094,163,264,150,264,13,14
건지사거리,42882,76,0,74,0,2,2
건지사거리,42883,4,242,4,242,0,8
건평,43168,54,64,50,64,4,3
건평,43186,18,55,17,55,1,2
건평리,43187,65,5,64,5,1,2
건평리,43651,13,62,12,62,1,2
건평마을회관,43594,1,44,1,44,0,1
건평입구,43170,3,12,3,12,0,0
건평입구,43331,9,3,9,3,0,0
걸포북변역,35560,51,2900,51,2900,0,98
걸포북변역,35610,2398,139,2372,139,26,84
걸포사거리.우리병원,35561,221,331,220,331,1,18
검단1차피오레·금호어울림아파트,89457,194,187,188,187,6,12
검단1차피오레·금호어울림아파트,89458,19,387,19,387,0,13
검단LH행복주택,89408,8490,2621,8418,2621,72,370
검단공구상가,89053,58,697,35,697,23,25
검단공구상가,89065,346,161,342,161,4,16
검단노인복지관,42695,205,432,181,432,24,21
검단농기구센터,89316,87,7,85,7,2,3
검단농기구센터,89324,2,140,2,140,0,4
검단농협,42432,25960,8807,25366,8807,594,1158
검단농협,42434,5201,14334,5025,14334,176,651
검단대성베르힐,89467,0,40,0,40,0,1
검단동행정복지센터(검단고교),42441,3696,7709,3531,7709,165,380
검단동행정복지센터(검단고교),42445,3591,4385,3493,4385,98,265
검단로지스틱스파크,41339,326,121,323,121,3,14
검단로지스틱스파크,42395,164,1257,164,1257,0,47
검단메가박스,42383,1833,1711,1803,1711,30,118
검단메가박스,42384,374,759,372,759,2,37
검단모아미래도엘리트,89466,16,3,16,3,0,0
검단모아엘가그랑데아파트,42483,39,350,39,350,0,12
검단사거리역,42419,14478,14680,14155,14680,323,971
검단사거리역,42426,2092,9162,2068,9162,24,375
검단사거리역,42427,8271,3192,8201,3192,70,382
검단사거리역,42537,10225,12442,10049,12442,176,755
검단신도시예미지더시그너스,89415,285,234,283,234,2,17
검단신도시예미지더시그너스,89416,8,258,8,258,0,8
검단신도시우미린리버포레,89409,3932,8284,3882,8284,50,407
검단오류공단,42702,7,549,7,549,0,18
검단오류공단,42703,503,8,482,8,21,17
검단오류역,89057,6387,752,6346,752,41,237
검단오류역,89060,469,5427,463,5427,6,196
검단오류역우방아이유쉘,89067,456,751,456,751,0,40
검단오류역우방아이유쉘,89068,997,181,972,181,25,39
검단오류풍림아이원,89251,120,351,112,351,8,15
검단오류풍림아이원,89252,445,129,437,129,8,19
검단우미린파크뷰2단지,89469,0,5,0,5,0,0
검단우방아이유쉘아파트,42688,393,498,369,498,24,29
검단원흥아파트,42400,1674,975,1599,975,75,88
검단원흥아파트,42401,1351,2659,1307,2659,44,133
검단지식산업센타,89054,8038,130,7809,130,229,272
검단지식산업센타,89063,171,5851,161,5851,10,200
검단초등학교,42475,8342,3830,8144,3830,198,405
검단초등학교,42482,3340,5518,3313,5518,27,295
검단초등학교,89332,66,145,64,145,2,7
검단초등학교,89333,148,125,139,125,9,9
검단출장소,42423,14952,10762,14669,10762,283,857
검단출장소,42424,4064,9965,3957,9965,107,467
검단탑종합병원,42877,418,626,384,626,34,34
검단하나아파트,42421,2282,556,2251,556,31,94
검단하나아파트,42422,422,436,410,436,12,28
검단힐스테이트5차아파트,42557,11,101,2,101,9,3
검단힐스테이트5차아파트,42558,239,477,226,477,13,23
검문소,43662,4,3,4,3,0,0
검문소,43812,70,110,63,110,7,6
검문소,90042,0,1,0,1,0,0
검문소,90043,8,111,8,111,0,3
검바위역,42348,4071,934,3999,934,72,166
검바위역,42349,1465,3363,1442,3363,23,160
검암경서동행정복지센터,42352,1936,5934,1892,5934,44,262
검암경서동행정복지센터,42353,5943,1763,5742,1763,201,256
검암사거리,42356,2418,3158,2360,3158,58,185
검암사거리,42357,4533,1757,4451,1757,82,209
검암사거리,42358,4339,1537,4278,1537,61,195
검암역(시내방면),42364,19538,2427,19354,2427,184,732
검암역(원당방면),42363,2182,26413,2073,26413,109,953
검암역.서해그랑블아파트,42360,5592,4590,5535,4590,57,339
검암역로열파크씨티푸르지오1단지,89167,1149,7,1048,7,101,38
검암역로열파크씨티푸르지오1단지,89168,83,822,2,822,81,30
검암역로열파크씨티푸르지오2단지,89169,520,15,512,15,8,17
검암역로열파크씨티푸르지오2단지,89170,134,735,23,735,111,28
검암역입구,42851,10330,6146,10241,6146,89,549
검암역입구,42852,5968,5979,5962,5979,6,398
검암역입구(시천교밑),89250,10711,2811,10685,2811,26,450
검암중학교,42359,3492,1557,3372,1557,120,168
검암중학교,42362,2581,2906,2562,2906,19,182
검암초등학교,42361,525,5944,512,5944,13,215
경기국제통상고.포도마을뉴서울.중앙공원,55042,610,1926,574,1926,36,84
경기국제통상고.포도마을뉴서울.중앙공원,55043,1573,1014,1518,1014,55,86
경기도교육청학생교육원,43162,0,101,0,101,0,3
경기도교육청학생교육원,43222,177,19,176,19,1,6
경기주유소,43051,77,345,75,345,2,14
경남1차,40343,9080,322,8880,322,200,313
경남1차아파트,40376,14590,6959,14445,6959,145,718
경남2차,40305,8649,71,8560,71,89,290
경남아너스빌,42099,3401,1698,3323,1698,78,169
경남아너스빌,42102,1323,3114,1270,3114,53,147
경남아너스빌아파트,42110,4705,2897,4618,2897,87,253
경남아너스빌아파트,42111,1712,2624,1683,2624,29,144
경남아파트,35143,8555,3132,8413,3132,142,389
경남아파트,35147,674,2134,637,2134,37,93
경남아파트,38281,8316,6863,8168,6863,148,505
경남아파트,41011,15077,4073,14849,4073,228,638
경남아파트,41014,3833,8068,3795,8068,38,396
경남아파트,42332,6844,3048,6775,3048,69,329
경남아파트,42334,3100,7296,3076,7296,24,346
경남아파트308동앞,40334,42,6928,40,6928,2,232
경남아파트311동앞,40300,14,5716,14,5716,0,191
경남아파트313동앞,40287,16,6199,13,6199,3,207
경동택배,89315,79,5,77,5,2,2
경동택배,89325,1,26,1,26,0,0
경명초등학교,89216,1461,484,1461,484,0,64
경명초등학교,89277,4527,7043,4504,7043,23,385
경명초등학교,89278,3985,5294,3967,5294,18,309
경방신약,39136,5117,1203,5111,1203,6,210
경방신약,39138,2346,8558,2344,8558,2,363
경복예식장,39399,9362,4597,9103,4597,259,465
경서농원,42333,196,509,189,509,7,23
경서농원,42335,57,1142,52,1142,5,39
경서지구입구,42303,881,4951,878,4951,3,194
경서지구입구,42671,2322,2452,2306,2452,16,159
경서지구입구,42672,3957,2638,3851,2638,106,219
경서초등학교,42569,4133,2231,4060,2231,73,212
경서초등학교,42570,2634,2397,2608,2397,26,167
경신마을,39646,181,125,179,125,2,10
경신마을,39982,159,1072,150,1072,9,41
경신아파트,41216,1901,1201,1872,1201,29,103
경신아파트,41223,1966,3542,1909,3542,57,183
경연초중학교,89271,5948,4065,5823,4065,125,333
경연초중학교,89272,3399,5033,3384,5033,15,281
경연초중학교·청라센텀로제비앙,89286,2054,991,2014,991,40,101
경연초중학교·호반베르디움6차,89285,1737,1735,1700,1735,37,115
경인계량소,42549,1095,7,1074,7,21,36
경인계량소,42550,5,765,4,765,1,25
경인교대.부평향교,41138,1009,1196,994,1196,15,73
경인교대.부평향교,41139,876,1038,868,1038,8,63
경인교대역입구,41428,9494,7449,9306,7449,188,564
경인교대역입구,41429,8334,9138,8246,9138,88,582
경인교회앞,40077,995,4144,973,4144,22,171
경인방송,37003,137,132,137,132,0,8
경인방송,37004,80,219,76,219,4,9
경인산업,39688,804,1474,802,1474,2,75
경인아라뱃길여객터미널,42869,417,13,414,13,3,14
경인여대,41277,10571,15799,10554,15799,17,879
경인여대,41278,5960,7126,5952,7126,8,436
경인특장,42547,278,7,267,7,11,9
경인항다목적부두,89151,114,1,114,1,0,3
경인항다목적부두,89152,0,78,0,78,0,2
경전말,43934,32,1,27,1,5,1
경제자유구역청,38514,2173,2171,2153,2171,20,144
경제자유구역청,38515,3165,3630,3134,3630,31,226
경진브로아,39042,974,1162,963,1162,11,71
경흥빌라,43372,439,7,405,7,34,14
경흥빌라,43616,1,211,1,211,0,7
경희유치원앞,39991,123,539,122,539,1,22
경희유치원앞,39992,155,240,147,240,8,13
계량소,40195,2380,315,2343,315,37,89
계룡리슈빌,55225,6189,1721,6186,1721,3,263
계산3동행정복지센터,41649,10,3,9,3,1,0
계산3동행정복지센터,41656,22,10,22,10,0,1
계산공고,41167,3133,3312,3032,3312,101,214
계산공고,41170,4979,8191,4906,8191,73,439
계산공고앞,41169,2818,1951,2738,1951,80,158
계산국민체육센터,41276,2083,3466,2053,3466,30,184
계산국민체육센터,41613,2403,2361,2352,2361,51,158
계산동수협,41533,4014,4758,3927,4758,87,292
계산동아아파트,41231,213,16,209,16,4,7
계산동우체국,41427,6894,4089,6849,4089,45,366
계산삼거리,41196,334,326,329,326,5,22
계산삼거리(신도브래뉴),41199,10404,10466,10294,10466,110,695
계산삼거리(신도브래뉴),41201,4479,8232,4403,8232,76,423
계산시장,41176,4240,4959,4190,4959,50,306
계산여고,41576,758,860,756,860,2,53
계산여자고등학교,41221,23,202,23,202,0,7
계산여자고등학교,41224,1169,1040,1143,1040,26,73
계산역,41247,6532,5516,6500,5516,32,401
계산역,41371,14114,1890,14059,1890,55,533
계산역,41426,28730,22379,28604,22379,126,1703
계산역,41431,24817,31147,24592,31147,225,1865
계산우체국,41430,10872,11853,10787,11853,85,757
계산전통시장,41648,7,3,5,3,2,0
계산전통시장,41657,1,24,1,24,0,0
계산주공아파트,41423,12502,13886,12299,13886,203,879
계산중학교,41577,303,51,303,51,0,11
계산현대아파트,41650,0,3,0,3,0,0
계양1동주민자치센터,41476,8152,1496,8045,1496,107,321
계양1동주민자치센터,41520,635,8168,595,8168,40,293
계양3동행정복지센터,41525,970,1482,970,1482,0,81
계양3동행정복지센터,41526,1203,880,1196,880,7,69
계양CGV,41140,3495,3713,3463,3713,32,240
계양경찰서,41184,9912,8364,9848,8364,64,609
계양경찰서,41185,6010,9093,5969,9093,41,503
계양경찰서,41195,20779,5414,20393,5414,386,873
계양경찰서·계양구청,41194,4262,16802,4173,16802,89,702
계양구의회,41123,5635,5020,5553,5020,82,355
계양구의회,41124,5640,6117,5484,6117,156,391
계양구청,41177,4573,4147,4557,4147,16,290
계양구청,41180,7624,9206,7543,9206,81,561
계양구청,41188,3755,1711,3705,1711,50,182
계양구청,41197,13,2331,13,2331,0,78
계양구청앞,41204,8158,3991,7993,3991,165,404
계양국제어학관,41651,0,2,0,2,0,0
계양도서관,41251,6127,10168,6047,10168,80,543
계양문화회관,41248,1814,1478,1791,1478,23,109
계양문화회관,41255,2810,4337,2777,4337,33,238
계양산성박물관,41285,1252,1941,1240,1941,12,106
계양산성박물관,41286,1037,2135,1020,2135,17,105
계양산장미원 입구(계산동자연풀장),41186,1054,686,1049,686,5,58
계양산장미원 입구(계산동자연풀장),41189,434,1062,427,1062,7,49
계양산전통시장,41297,681,5258,671,5258,10,197
계양산전통시장,41298,5279,1434,5116,1434,163,223
계양산전통시장,41306,20453,19083,20178,19083,275,1317
계양산지구대,41281,947,1375,940,1375,7,77
계양산지구대,41282,919,1336,894,1336,25,75
계양새마을금고,41094,1514,1619,1483,1619,31,104
계양새마을금고,41097,1685,2260,1646,2260,39,131
계양세무서,41054,1317,1214,1286,1214,31,84
계양세무서,41058,739,1219,731,1219,8,65
계양센트레빌1단지,41550,5874,5315,5769,5315,105,372
계양센트레빌1단지,41627,957,589,957,589,0,51
계양센트레빌1단지,41628,203,777,203,777,0,32
계양센트레빌1단지(111동앞),41551,7496,5748,7457,5748,39,441
계양센트레빌2단지,41625,326,1034,316,1034,10,45
계양여성회관,41404,3698,4044,3649,4044,49,258
계양역,41357,126539,57634,126202,57634,337,6139
계양역,41358,64073,111094,63840,111094,233,5838
계양역(귤현역방면),41659,4376,53,4332,53,44,147
계양임광그대가아파트,41118,3646,188,3518,188,128,127
계양종합사회복지관,41120,487,1264,485,1264,2,58
계양종합사회복지관,41121,1463,637,1423,637,40,70
계양중학교,41340,2722,1309,2635,1309,87,134
계양중학교,41341,1634,7564,1606,7564,28,306
계양체육관(아시아드양궁장),41454,459,994,455,994,4,48
계양체육관(아시아드양궁장),41455,1901,729,1892,729,9,87
계양체육관(아시아드양궁장),41567,2467,679,2448,679,19,104
계양체육관(아시아드양궁장),41568,612,4444,612,4444,0,168
계양체육관(효성해링턴플레이스),41440,3639,936,3622,936,17,152
계양체육관.대동아파트,41173,78,1945,60,1945,18,67
고구1리입구,90006,42,8,39,8,3,1
고구1리입구,90007,1,55,1,55,0,1
고구2리마을회관입구,90014,2,104,1,104,1,3
고구2리마을회관입구,90015,104,2,93,2,11,3
고구저수지,90008,2,33,2,33,0,1
고구저수지,90009,25,2,25,2,0,0
고구촌,90012,1,51,1,51,0,1
고구촌,90013,61,2,61,2,0,2
고능2리 종점,90372,15,4,9,4,6,0
고능2리능촌마을회관,90371,0,3,0,3,0,0
고능리공소,90208,138,115,126,115,12,8
고능리입구,43291,14,43,12,43,2,1
고능리입구,43534,50,17,48,17,2,2
고다니마을9단지,80362,104,50,103,50,1,5
고려산업,39486,917,1315,909,1315,8,74
고려양행,39111,967,1625,951,1625,16,86
고려저수지입구,43249,34,72,33,72,1,3
고려저수지입구,43486,59,44,56,44,3,3
고비고개정상,43569,13,2,13,2,0,0
고비고개정상,43844,1,15,1,15,0,0
고산마을입구,90016,2,27,2,27,0,0
고산마을입구,90017,9,1,6,1,3,0
고산촌,43544,153,42,135,42,18,6
고산촌,43779,44,142,44,142,0,6
고상골,43269,6,67,5,67,1,2
고상골,43382,32,6,31,6,1,1
고상골입구,43266,96,11,84,11,12,3
고상골입구,43552,17,71,17,71,0,2
고속터미널,31017,14056,268,14035,268,21,477
고속터미널,31018,475,21538,475,21538,0,733
고시기(가재골),43770,12,1,8,1,4,0
고시기(가재골),90126,0,1,0,1,0,0
고염나무골,35473,7,154,7,154,0,5
고염나무골,35474,216,15,208,15,8,7
고인돌입구,43550,2,16,2,16,0,0
고인돌체육관(태권도경기장),43383,3,6,3,6,0,0
고인돌체육관앞,90045,45,311,45,311,0,11
고인돌체육관앞,90046,428,67,414,67,14,16
고잔고등학교,39691,227,2429,221,2429,6,88
고잔마을,43284,55,0,53,0,2,1
고잔마을,43532,1,31,1,31,0,1
고창마을.KCC,80328,217,208,217,208,0,14
고창촌,43076,29,108,29,108,0,4
고창촌입구,43166,24,1,19,1,5,0
고창촌입구,43345,0,18,0,18,0,0
고천3리마을회관,43341,93,3,90,3,3,3
고천3리마을회관,43574,6,57,5,57,1,2
고천5리마을회관,90341,18,0,14,0,4,0
고천5리마을회관,90345,0,38,0,38,0,1
고천교,43339,39,24,38,24,1,2
고천교,43849,23,12,19,12,4,1
고촌역,80061,3834,631,3823,631,11,148
고촌역,80062,515,6794,515,6794,0,243
고합아파트,70036,199,138,186,138,13,11
고향산천,43464,6,6,4,6,2,0
고향산천,43610,14,19,9,19,5,1
곡촌,43427,11,23,10,23,1,1
곡촌,43457,88,5,71,5,17,3
곡촌,43789,74,47,72,47,2,4
곡촌,43816,4,66,4,66,0,2
곤능,43197,5,62,2,62,3,2
곤능,43319,62,2,57,2,5,2
골드클래스,42936,232,862,180,862,52,36
공개마을,90195,20,7,20,7,0,0
공개마을,90196,3,17,3,17,0,0
공구상가,36092,492,1706,456,1706,36,73
공구상가.간동입구,80021,1038,87,1016,87,22,37
공군8547부대앞,35718,21,48,17,48,4,2
공군8547부대앞,35719,8,127,8,127,0,4
공군회관,19255,106,0,106,0,0,3
공군회관,20107,5,152,5,152,0,5
공단공구상가,92048,0,32,0,32,0,1
공단공원앞,42739,115,216,114,216,1,11
공단공원앞,42740,242,60,240,60,2,10
공단본부,42270,311,910,310,910,1,40
공단본부,42756,3354,855,3330,855,24,140
공단본부,42757,964,2553,951,2553,13,117
공단사거리,42995,4,913,4,913,0,30
공단사거리,42996,1361,7,1280,7,81,45
공단사거리,89069,23,227,23,227,0,8
공단사거리,89070,289,566,273,566,16,28
공단소방서,39062,1422,3431,1405,3431,17,161
공단시장,37426,3195,5777,3137,5777,58,299
공단시장,37427,7467,3230,7412,3230,55,356
공단오거리,40565,1913,584,1889,584,24,83
공단오거리,40566,356,2759,347,2759,9,103
공단유통상가,42940,51,1267,50,1267,1,43
공단유통상가,42941,1242,25,1179,25,63,42
공단자동차,42022,1437,1986,1402,1986,35,114
공단치안센터,37444,1859,1038,1841,1038,18,96
공단치안센터,37445,488,1698,480,1698,8,72
공단회관,39119,1503,3738,1500,3738,3,174
공단회관,39123,3041,1102,3040,1102,1,138
공덕오거리,14149,363,157,363,157,0,17
공설운동장,43091,18,322,17,322,1,11
공설운동장,43092,145,164,135,164,10,10
공숙입구,43290,11,61,11,61,0,2
공숙입구,43490,42,54,39,54,3,3
공영산업,89148,8,598,8,598,0,20
공작아파트,39479,2080,3486,2006,3486,74,185
공작아파트,39480,3175,4755,3147,4755,28,264
공장단지입구,42555,204,134,200,134,4,11
공촌마을,42323,4654,3122,4538,3122,116,259
공촌마을,42598,2407,3753,2338,3753,69,205
공촌사거리,42324,17064,10247,17026,10247,38,910
공촌사거리,42330,15444,15425,15391,15425,53,1028
공촌사거리,42331,639,512,627,512,12,38
공촌사거리(한국아파트),42322,4700,5196,4661,5196,39,329
공촌정수장,42340,158,136,158,136,0,9
공촌정수장,42341,92,265,90,265,2,11
공항고등학교,35116,2663,528,2517,528,146,106
공항고속도로진입(미정차),35644,2,0,2,0,0,0
공항교회앞,35123,1212,2014,1204,2014,8,107
공항신도시(메디컬사거리),35258,602,1770,597,1770,5,79
공항중학교,35117,938,1602,935,1602,3,84
공항초등학교,35087,131,355,114,355,17,16
관곡마을,90104,0,11,0,11,0,0
관곡마을,90105,21,0,21,0,0,0
관광밸트입구,43874,6,0,0,0,6,0
관광밸트입구,43875,2,3,2,3,0,0
관교여자중학교,37226,9138,8836,8975,8836,163,599
관교여자중학교,37229,2622,2800,2565,2800,57,180
관교여자중학교,37231,3156,3667,3064,3667,92,227
관교중학교,37200,158,959,152,959,6,37
관교중학교(약수터),37202,4569,7525,4458,7525,111,403
관교중학교(약수터),37203,10023,6372,9795,6372,228,546
관리공단본부,42720,627,88,621,88,6,23
관창마을,35252,1401,764,1341,764,60,72
관창마을,35253,1779,1909,1728,1909,51,122
광명아파트,37434,14030,6846,13927,6846,103,695
광명아파트,39348,7509,14386,7438,14386,71,729
광명아파트,39835,25,889,7,889,18,30
광명아파트,40590,2630,974,2584,974,46,120
광명아파트,40817,7405,1552,7319,1552,86,298
광명아파트,41096,568,2414,546,2414,22,99
광명아파트,41098,2725,799,2645,799,80,117
광명아파트,41108,14397,20266,14280,20266,117,1155
광명아파트,41448,2465,7962,2408,7962,57,347
광명역IC출입(미정차),53042,10,0,10,0,0,0
광명항,35708,68,1,66,1,2,2
광명항,35714,2007,1585,1992,1585,15,119
광성보,43674,24,118,24,118,0,4
광성오리,43128,13,1,13,1,0,0
광성오리,43862,4,35,4,35,0,1
광일아파트,40855,3585,1028,3498,1028,87,153
광일아파트,40874,1671,3265,1644,3265,27,164
교대역,31013,24844,22747,24824,22747,20,1586
교대입구,41141,2069,3052,2030,3052,39,170
교대입구,41142,3214,2140,3105,2140,109,178
교대후문,41362,1427,301,1415,301,12,57
교대후문,41363,253,2941,249,2941,4,106
교동중고후문,90024,2,61,2,61,0,2
교동중고후문,90025,105,2,98,2,7,3
교보생명,37357,23237,80326,22992,80326,245,3452
교산교회,43496,35,9,30,9,5,1
교산교회,43719,10,18,8,18,2,0
교산리입구,43694,38,40,22,40,16,2
교산리입구,43748,44,16,30,16,14,2
교산상회앞,43494,2,4,2,4,0,0
교산상회앞,43715,2,1,2,1,0,0
교육개발원입구,31005,929,7,926,7,3,31
교육개발원입구,31006,54,881,53,881,1,31
교통방송사거리,37538,792,2210,720,2210,72,100
교통방송사거리,37539,1021,1553,1000,1553,21,85
교통연수원,41191,558,2234,539,2234,19,93
교통연수원,41192,2144,1181,2130,1181,14,110
교회앞,43216,12,8,11,8,1,0
교회앞,43309,18,15,14,15,4,1
교회앞,43430,19,16,16,16,3,1
교회앞,43818,30,27,27,27,3,1
교회앞,90338,3,27,3,27,0,1
교회앞,90348,28,0,18,0,10,0
구검문소,43196,0,62,0,62,0,2
구검문소,43622,135,4,127,4,8,4
구능재,90193,24,4,24,4,0,0
구능재,90194,2,29,2,29,0,1
구도일주유소,40902,108,1518,98,1518,10,54
구두물입구,35219,343,195,339,195,4,17
구래리,80006,341,1530,333,1530,8,62
구래리,80007,1590,364,1570,364,20,65
구래역,80337,8665,16114,8589,16114,76,825
구래역,80338,19690,9344,19265,9344,425,967
구렁목,43950,198,10,189,10,9,6
구렁목,43951,2,103,2,103,0,3
구름다리,35735,21,230,21,230,0,8
구름다리,35736,28,3,28,3,0,1
구반포역.세화고등학교,31031,1391,31,1390,31,1,47
구봉도입구,62035,28,420,28,420,0,14
구봉도입구,62037,425,17,418,17,7,14
구북성초교,43506,7,0,4,0,3,0
구북성초교,43656,8,10,8,10,0,0
구산사거리,40233,677,396,669,396,8,35
구산사거리,40842,445,19456,384,19456,61,663
구산사거리,40843,3115,7176,3001,7176,114,343
구산중학교,40518,808,924,794,924,14,57
구선택초교,43239,7,4,2,4,5,0
구선택초교,43896,3,6,3,6,0,0
구월1동행정복지센터,39967,1040,3,1035,3,5,34
구월1동행정복지센터,39981,0,493,0,493,0,16
구월2동행정복지센터,39586,3712,391,3705,391,7,136
구월2동행정복지센터,39607,363,2959,360,2959,3,110
구월도매전통시장,39192,18952,15387,18558,15387,394,1144
구월도매전통시장,39193,21159,31531,20964,31531,195,1756
구월동로데오거리,39195,4598,1054,4537,1054,61,188
구월동우체국,39211,3693,12627,3619,12627,74,544
구월동팬더아파트,39237,9338,8762,9211,8762,127,603
구월동팬더아파트,39238,10155,7107,9988,7107,167,575
구월서초등학교,39204,7540,6633,7405,6633,135,472
구월서초등학교,39205,6596,5571,6510,5571,86,405
구월아시아드1단지,39912,623,3,616,3,7,20
구월아시아드1단지,39913,0,119,0,119,0,3
구월아시아드5단지정문,39883,2476,6104,2446,6104,30,286
구월아시아드5단지후문,39881,2382,4600,2323,4600,59,232
구월아시아드6단지,39885,20825,7685,20591,7685,234,950
구월아시아드6단지,39886,6930,14598,6878,14598,52,717
구월아시아드7단지,39892,1509,2147,1479,2147,30,121
구월아시아드8단지,39891,2807,1207,2760,1207,47,133
구월아시아드8단지,39948,72,445,69,445,3,17
구월아시아드8단지,39949,93,236,87,236,6,10
구월아시아드선수촌센트럴자이,39884,3621,2392,3573,2392,48,200
구월아시아드선수촌아파트,39202,1000,830,999,830,1,61
구월아시아드선수촌아파트,39203,763,1797,760,1797,3,85
구월아시아드은빛호수공원,39914,9914,5522,9759,5522,155,514
구월아시아드은빛호수공원,39915,6596,6039,6487,6039,109,421
구월우체국,39213,9257,7441,9104,7441,153,556
구월중학교,39281,26479,18856,25867,18856,612,1511
구월중학교,39286,19417,28974,19023,28974,394,1613
구월체육공원,39384,3502,4867,3458,4867,44,278
구월초등학교,39832,1908,4125,1856,4125,52,201
구월초등학교,39833,3962,2137,3852,2137,110,203
구월한내들퍼스티지,39882,4244,1823,4201,1823,43,202
구장수파출소,39375,685,617,674,617,11,43
구재이,43282,28,14,25,14,3,1
구재이,43551,3,7,3,7,0,0
구정슈퍼앞,35498,4,43,4,43,0,1
구정슈퍼앞,35587,39,6,39,6,0,1
구정정미소,90284,4,17,4,17,0,0
구정정미소,90306,19,1,19,1,0,0
구중학교앞,44119,4,4,4,4,0,0
구중학교앞,44148,8,1,3,1,5,0
구하1리입구,43259,1,33,1,33,0,1
구하1리입구,43562,105,2,90,2,15,3
구하2리마을회관,43254,127,0,125,0,2,4
구하2리마을회관,43256,45,2,43,2,2,1
구하2리마을회관,43373,0,66,0,66,0,2
구하2리마을회관,43559,0,81,0,81,0,2
국궁장앞,70151,39,213,36,213,3,8
국립생물자원관,89111,228,548,213,548,15,25
국립생물자원관입구,42741,266,495,266,495,0,25
국립인천공항검역소,35430,11,506,5,506,6,17
국립인천공항검역소,35431,169,81,169,81,0,8
국민건강보험 인천부평지사,40620,1232,4631,1214,4631,18,195
국민건강보험 인천부평지사,40621,3922,1522,3840,1522,82,181
국민건강보험남부지사,37274,8904,10356,8757,10356,147,642
국민은행,38148,1917,4585,1903,4585,14,216
국민은행,38149,4677,2120,4572,2120,105,226
국민은행연수중앙지점,38129,6099,4240,6013,4240,86,344
국민은행연수중앙지점,38571,2170,4227,2137,4227,33,213
국제금융단지,89292,7457,5412,7364,5412,93,428
국제금융단지,89293,2336,5049,2333,5049,3,246
국제성모병원,89030,331,1377,324,1377,7,56
국제성모병원,89031,2355,931,2342,931,13,109
국제성모병원(종점),89369,2,104,2,104,0,3
국제업무단지(공항청사),35026,14773,2879,14563,2879,210,588
국제업무지구역,38528,1437,3111,1431,3111,6,151
국제업무지구역5번출구,38619,2204,1917,2201,1917,3,137
국제이노베이션,37573,8,1313,6,1313,2,44
국제이노베이션,37574,1288,12,1283,12,5,43
국제콘크리트,90050,74,49,74,49,0,4
국제콘크리트,90051,15,136,15,136,0,5
국제학교,38457,2446,610,2385,610,61,101
국제학교,38462,1041,2489,1018,2489,23,117
국촌,43251,135,3,123,3,12,4
국촌,43371,1,87,1,87,0,2
국화리야영장앞,43353,69,3,67,3,2,2
국화리야영장앞,43843,2,64,1,64,1,2
국화맨션,43359,0,6,0,6,0,0
국화맨션,43566,23,6,23,6,0,0
국회연수원입구,43919,8,4,7,4,1,0
국회연수원입구,43920,0,20,0,20,0,0
군인아파트,43046,106,55,106,55,0,5
군인아파트,43047,20,121,20,121,0,4
굴다리,37142,8088,106,8088,106,0,273
굴다리오거리,40231,19425,8603,19044,8603,381,934
굴다리오거리,40232,15457,23038,15301,23038,156,1283
굴다리입구,37152,7240,3766,6951,3766,289,366
굴포천,40506,2353,2327,2287,2327,66,156
굴포천,40509,2578,3814,2531,3814,47,213
굴포천역(롯데마트),40814,42222,25988,41956,25988,266,2273
굴포천역(롯데마트),40815,18871,22369,18733,22369,138,1374
굴포천역(부평농협),40507,6451,8312,6427,8312,24,492
굴포천역(부평농협),40508,9298,6337,9212,6337,86,521
굴포천역(신복사거리),40485,4098,18940,4071,18940,27,767
굴포천역(신복사거리),40498,29260,7100,29063,7100,197,1212
굴포천역(욱일아파트),40519,4559,12607,4536,12607,23,572
굴포천역(욱일아파트),40522,7273,2903,7225,2903,48,339
궁골,43346,1,9,1,9,0,0
궁골,43572,14,0,14,0,0,0
궁현사거리,37575,4,908,3,908,1,30
궁현사거리,37576,478,16,477,16,1,16
귀뚜라미보일러,42003,2,148,1,148,1,5
귀뚜라미보일러,42004,144,0,140,0,4,4
귤현감리교회,41385,2267,5500,2216,5500,51,258
귤현감리교회,41386,4826,3186,4778,3186,48,267
귤현동마을입구,41326,535,119,527,119,8,21
귤현동마을입구,41328,40,595,39,595,1,21
귤현아이파크정문,41572,2217,469,2217,469,0,89
귤현역,41331,6781,4184,6761,4184,20,365
귤현역,41332,1883,933,1857,933,26,93
귤현차량기지(센트레빌3단지),41443,3043,914,3019,914,24,131
귤현차량기지(센트레빌3단지),41444,1278,3826,1230,3826,48,170
귤현차량기지(안골공원),41618,1686,2659,1676,2659,10,144
귤현차량기지(안골공원),41619,134,564,134,564,0,23
귤현현대아이파크,41620,642,1859,642,1859,0,83
그린나래지하차도,35648,12,467,12,467,0,15
그린나래지하차도,35649,2086,745,2072,745,14,94
그린빌라,42222,2137,1339,2092,1339,45,115
그린빌라,42602,1359,2956,1344,2956,15,143
그린힐아파트.e편한세상아파트,40194,281,1856,276,1856,5,71
극동.금호아파트,39272,4990,7256,4839,7256,151,408
극동.금호아파트,39278,6456,5495,6384,5495,72,398
극지연구소,39918,2245,2646,2222,2646,23,163
극지연구소,39919,3673,2561,3662,2561,11,207
근대문화거리입구,35369,2344,4385,2270,4385,74,224
근대문화거리입구,35370,3294,1941,3222,1941,72,174
근로복지공단인천병원,40145,10375,13051,10270,13051,105,780
근로복지공단인천병원,40155,20764,9902,20682,9902,82,1022
글로벌캠퍼스푸르지오,39841,2744,7594,2688,7594,56,344
글로벌파크,39975,481,913,475,913,6,46
글로벌파크,39976,119,1460,117,1460,2,52
글로벌파크베르디움,39840,6599,1475,6554,1475,45,269
금강다이아몬드,39007,591,1607,585,1607,6,73
금강다이아몬드,39008,962,451,962,451,0,47
금강마을,55066,1699,2208,1648,2208,51,130
금강마을,55068,4630,824,4599,824,31,181
금강요양병원,37291,8381,5719,8229,5719,152,470
금강종합상가,42858,1083,60,1045,60,38,38
금강찜질방,44113,37,33,33,33,4,2
금강찜질방,44149,16,5,16,5,0,0
금강찜질방,44150,5,29,5,29,0,1
금강찜질방,44151,3,2,3,2,0,0
금강탱크터미널,42758,1128,2293,1106,2293,22,114
금강펜테리움더시글로,89392,8949,2262,8891,2262,58,373
금강펜테리움더시글로,89459,692,2868,667,2868,25,118
금곡교차로,89370,8,59,8,59,0,2
금곡동,42471,7,195,5,195,2,6
금곡동,42587,678,78,670,78,8,25
금곡종점,89319,114,119,102,119,12,7
금란마트,89056,78,1026,73,1026,5,36
금란마트,89061,9,505,3,505,6,17
금마초등학교,40833,6521,3860,5992,3860,529,346
금산경로당,35564,2,193,2,193,0,6
금산경로당,35565,12,3,12,3,0,0
금성목재,42812,0,181,0,181,0,6
금운교,43298,0,24,0,24,0,0
금운교,43858,6,31,3,31,3,1
금월리종점,43777,160,80,143,80,17,8
금정골입구,90301,0,5,0,5,0,0
금정부락,90300,4,0,4,0,0,0
금호2차아파트,37031,7077,1193,6930,1193,147,275
금호2차아파트,37033,1889,4434,1846,4434,43,210
금호베스트빌1단지.영종도서관,35112,1084,2214,1074,2214,10,109
금호베스트빌1단지.영종도서관,35113,3681,1286,3659,1286,22,165
금호아파트,37061,241,563,235,563,6,26
금호아파트,38302,626,812,623,812,3,47
금호아파트,38349,10821,2796,10666,2796,155,453
금호아파트,40441,3485,1249,3421,1249,64,157
금호아파트,40795,20306,19684,20194,19684,112,1333
금호아파트,40845,7118,7907,7062,7907,56,500
금호어울림,35313,2893,1185,2835,1185,58,135
금호어울림,35384,941,2738,917,2738,24,122
금호어울림,37048,1235,2114,1178,2114,57,111
금호어울림2차,35597,24,1,24,1,0,0
금호어울림2차,35598,1,14,1,14,0,0
금호어울림아파트,42137,3892,2383,3853,2383,39,209
금호어울림아파트,42139,2324,2798,2267,2798,57,170
금호어울림아파트,42592,215,1216,202,1216,13,47
금호어울림아파트,42593,1350,784,1315,784,35,71
금호이수마운트밸리,40316,424,883,422,883,2,43
금호종합열처리,42801,566,152,565,152,1,23
금호타운,37024,14014,3463,13689,3463,325,582
금호타운,37026,4738,14824,4687,14824,51,652
금홍염전,35543,519,210,501,210,18,24
금홍염전,35544,338,2892,324,2892,14,107
기계공고,37294,4778,2813,4637,2813,141,253
기계철제단지,36129,3,252,3,252,0,8
기계철제단지,36149,242,47,231,47,11,9
기신정기,39567,701,1524,701,1524,0,74
기업은행(구월동지점),39178,278,538,259,538,19,27
기업은행앞,70152,238,19,238,19,0,8
긴마루교회입구,35686,91,30,83,30,8,4
긴마루교회입구,35692,19,32,19,32,0,1
길병원,39250,79830,79031,78966,79031,864,5295
길병원,39262,14553,11474,14366,11474,187,867
길병원,39264,6325,9381,6242,9381,83,523
길병원,39590,77151,68584,76421,68584,730,4857
길병원사거리,39212,20260,19751,19927,19751,333,1333
길병원사거리,39216,20766,24962,20345,24962,421,1524
길상교회,43148,36,6,36,6,0,1
길상교회,43701,4,50,4,50,0,1
길상군립어린이집,43959,81,21,81,21,0,3
길상군립어린이집,43960,27,125,27,125,0,5
길상낚시터,43149,7,15,7,15,0,0
길상낚시터,43883,4,7,4,7,0,0
길상보건지소,43021,270,560,234,560,36,27
길상보건지소,43069,345,275,304,275,41,20
길정저수지,90054,4,3,2,3,2,0
길정저수지,90055,2,11,2,11,0,0
길주초등학교,41654,3,1,3,1,0,0
길직1리,43270,82,154,78,154,4,7
길직리,43031,178,114,171,114,7,9
길직리입구,43304,3,67,3,67,0,2
길직리입구,43313,22,29,22,29,0,1
길훈4차아파트,80040,13,263,13,263,0,9
길훈4차아파트,80041,238,1,238,1,0,7
길훈아파트,42494,7859,8694,7797,8694,62,551
김미현골프장,39749,1385,746,1376,746,9,71
김미현골프장,39751,695,1667,694,1667,1,78
김소골,35675,20,23,20,23,0,1
김소골,35703,59,19,59,19,0,2
김지곡,43455,0,59,0,59,0,1
김지곡,43831,84,0,74,0,10,2
김포공항국내선,25029,2091,3001,2040,3001,51,169
김포공항국내선,25091,578,131,569,131,9,23
김포공항국제선,25006,825,4236,820,4236,5,168
김포공항국제선,25164,68,182,67,182,1,8
김포대학입구,80257,585,34,579,34,6,20
김포대학입구,80258,31,567,28,567,3,19
김포초교,80028,164,633,163,633,1,26
김포초교,80030,670,144,670,144,0,27
김포한강신협,80032,1007,812,985,812,22,60
김포한강신협,80035,1096,1213,1091,1213,5,76
까치공원.작전도서관,41149,14972,11803,14800,11803,172,892
까치말사거리,41563,9073,3087,9049,3087,24,405
까치말사거리,41564,2800,7033,2763,7033,37,327
꿈동산.사랑마을,55022,2002,2276,1992,2276,10,142
꿈동산.사랑마을,55024,1633,139,1621,139,12,59
꿈에그린아파트,92023,3746,4583,3670,4583,76,277
나누리병원,40398,28403,20338,28074,20338,329,1624
나누리병원,40784,24321,20090,24063,20090,258,1480
나래병원,38142,2485,1950,2485,1950,0,147
나룻개,35593,93,236,93,236,0,10
나룻개,35594,203,40,188,40,15,8
나룻개입구,35385,20,301,20,301,0,10
나룻개입구,35386,266,23,257,23,9,9
나무깨,90183,1,2,1,2,0,0
나무깨,90184,3,5,0,5,3,0
나무다리,90340,0,13,0,13,0,0
나무다리,90344,19,0,19,0,0,0
나사렛국제병원앞,38068,47528,15014,46787,15014,741,2084
나은병원,42056,7038,2129,6956,2129,82,305
낚시터매점,43356,5,20,5,20,0,0
낚시터매점,43840,32,1,30,1,2,1
낚시터입구,42802,134,608,134,608,0,24
난곳정미소,90286,71,82,71,82,0,5
난정1리마을회관,90285,40,19,40,19,0,1
난정1리마을회관,90287,8,2,8,2,0,0
난정보건진료소앞,90289,5,3,5,3,0,0
난정초등학교입구,90305,24,5,24,5,0,0
남광로얄아파트,37257,21024,28106,20574,28106,450,1637
남광하우스토리,42841,3390,798,3352,798,38,139
남광하우스토리,42920,4654,1447,4584,1447,70,203
남광하우스토리,42921,1692,3932,1662,3932,30,187
남동I.C(문학동입구),39168,362,4570,317,4570,45,164
남동경기장,92055,309,103,305,103,4,13
남동경찰서·남촌농산물도매시장,39147,3535,1877,3477,1877,58,180
남동경찰서·남촌농산물도매시장,39148,2400,1567,2367,1567,33,132
남동고등학교,92035,187,151,185,151,2,11
남동고등학교,92036,6,77,6,77,0,2
남동공단2호공원,39075,794,5666,794,5666,0,215
남동공단근린공원앞,39073,5339,826,5329,826,10,205
남동공단우체국,39076,1889,6569,1882,6569,7,281
남동구청,39263,11285,7554,11243,7554,42,627
남동구청,39279,11008,14478,10890,14478,118,849
남동구청역,39318,12393,8181,12317,8181,76,685
남동구청역,39324,13160,14952,12919,14952,241,937
남동구청후문(남동등기소),39287,6061,10550,5926,10550,135,553
남동구청후문(남동등기소),39288,4760,3063,4680,3063,80,260
남동국가산업단지 입구,39853,506,18,491,18,15,17
남동국가산업단지(기신정기),39568,1451,1254,1418,1254,33,90
남동대교,38090,2183,7392,2117,7392,66,319
남동대교(스퀘어원),39063,5403,2987,5224,2987,179,279
남동빌라,39330,5039,2019,4941,2019,98,235
남동세무서,39887,22477,11854,22239,11854,238,1144
남동세무서,39888,13710,23427,13555,23427,155,1237
남동소래아트홀,39743,388,94,388,94,0,16
남동소래아트홀,39744,307,90,307,90,0,13
남동소래아트홀,39748,174,230,174,230,0,13
남동소래아트홀,39792,129,337,129,337,0,15
남동소방서,39252,919,2666,895,2666,24,119
남동소방서,39587,10723,7052,10508,7052,215,592
남동시범공단앞,39100,3707,5146,3690,5146,17,295
남동시범공단앞,39102,5992,2826,5962,2826,30,293
남동아시아드럭비경기장,39214,305,848,301,848,4,38
남동아시아드럭비경기장,39215,364,581,337,581,27,31
남동인더스파크역,39074,12844,2239,12800,2239,44,502
남동인더스파크역1번출구,92045,138,1,138,1,0,4
남동인더스파크역1번출구,92050,2,128,2,128,0,4
남동정수장,39372,297,787,293,787,4,36
남동중학교,39220,10881,6305,10799,6305,82,572
남동중학교,39224,5797,5373,5724,5373,73,372
남동체육관,39930,699,947,691,947,8,54
남동체육관,39947,727,1423,727,1423,0,71
남동체육관(체조경기장),39682,1411,2592,1376,2592,35,133
남동체육관(체조경기장),39862,974,602,969,602,5,52
남동초등학교,39254,18135,27737,18055,27737,80,1529
남동초등학교,39255,32843,15904,32552,15904,291,1624
남동초등학교,39265,4891,532,4806,532,85,180
남동화원,39300,7114,6144,7065,6144,49,441
남디4거리,35271,191,863,175,863,16,35
남디4거리,35280,372,383,352,383,20,25
남부고가교,40921,9,200,9,200,0,6
남산리,43324,1,0,1,0,0,0
남산리,43628,14,12,14,12,0,0
남산유스호스텔,43982,16,0,16,0,0,0
남산유스호스텔,43985,5,23,5,23,0,0
남산포입구,90030,1,19,1,19,0,0
남산포입구,90031,47,0,37,0,10,1
남성네고개,35426,13,150,13,150,0,5
남성네고개,35427,124,16,124,16,0,4
남씨농원앞,41495,32,74,32,74,0,3
남씨농원앞,41511,46,1,46,1,0,1
남양목재,42814,0,139,0,139,0,4
남인천농협백운지점,37174,201,954,197,954,4,38
남인천새마을금고중앙지점,37300,16408,14773,16046,14773,362,1039
남인천여자중학교,39190,18762,6027,18260,6027,502,826
남인천여자중학교,39191,7982,17471,7839,17471,143,848
남중학교,37331,6876,621,6740,621,136,249
남중학교,37336,5889,17207,5761,17207,128,769
남청라TG,89379,96,6,93,6,3,3
남청라TG,89380,4,81,1,81,3,2
남촌농산물도매시장,92031,7905,156,7707,156,198,268
남촌농산물도매시장,92032,76,5061,42,5061,34,171
남촌농산물도매시장채소동앞,92033,78,1883,72,1883,6,65
남촌농산물도매시장채소동앞,92034,491,626,477,626,14,37
남촌동다목적센터,39908,99,1425,97,1425,2,50
남촌동다목적체육센터,39907,312,251,301,251,11,18
남촌동입구,39166,4051,9167,3988,9167,63,440
남촌입구,39156,264,708,247,708,17,32
남촌입구,39157,567,1664,535,1664,32,74
남촌풍림2차아파트,39171,6047,11095,5935,11095,112,571
남촌풍림3차아파트,39165,4723,4155,4655,4155,68,295
남촌풍림3차아파트,39167,4230,4906,4119,4906,111,304
남촌풍림아파트,39172,12740,3356,12601,3356,139,536
남항유어선부두,35078,5279,1682,5051,1682,228,232
남항유어선부두,35079,188,4631,146,4631,42,160
납섬입구,90185,26,7,18,7,8,1
납섬입구,90186,8,13,6,13,2,0
내2리마을회관앞,44138,90,32,88,32,2,4
내2리마을회관앞,44152,7,14,7,14,0,0
내3리다목적회관앞,44121,3,1,3,1,0,0
내3리다목적회관앞,44153,5,0,5,0,0,0
내3리마을회관,44154,6,2,6,2,0,0
내3리마을회관,44155,16,8,16,8,0,0
내3리마을회관,44156,7,22,0,22,7,0
내4리마을회관,44104,20,42,19,42,1,2
내4리마을회관,44157,17,2,17,2,0,0
내5리마을회관,44128,1,0,1,0,0,0
내5리마을회관,44158,2,0,2,0,0,0
내7리마을회관,44118,0,3,0,3,0,0
내7리마을회관,44159,11,8,5,8,6,0
내가면사무소(맞은편),43906,105,44,99,44,6,4
내가면사무소(사무소),43907,70,127,69,127,1,6
내가시장,43392,177,324,171,324,6,16
내가시장,43484,438,254,397,254,41,23
내가초등학교,43368,80,34,67,34,13,3
내가초등학교,43554,27,107,24,107,3,4
내건너,90167,35,51,31,51,4,2
내건너,90168,27,25,27,25,0,1
내동교회,44114,6,11,6,11,0,0
내리교회,43395,10,12,9,12,1,0
내리교회,43543,59,49,49,49,10,3
내리쉼터,43968,11,9,11,9,0,0
내리쉼터,43972,13,4,13,4,0,0
내리어촌계사무실,44135,3,2,3,2,0,0
내리주유소.한국화장품삼거리,57016,1461,1626,1450,1626,11,102
내리주유소.한국화장품삼거리,57018,2051,2030,2016,2030,35,136
내촌,43343,77,63,74,63,3,4
내촌,43581,64,16,61,16,3,2
내촌입구,90394,0,15,0,15,0,0
너출(드무리입구),44086,0,1,0,1,0,0
너출(드무리입구),44161,3,0,2,0,1,0
넘말,43140,0,2,0,2,0,0
넘말,43438,5,4,4,4,1,0
넙디,35574,1434,6026,1392,6026,42,248
넙디,35575,8102,1241,7940,1241,162,311
넙디마을입구,35389,77,106,77,106,0,6
노가리해변,44162,1,0,1,0,0,0
노랑새고개,43273,142,43,136,43,6,6
노랑새고개,43570,41,158,40,158,1,6
노인복지회관,37599,132,714,130,714,2,28
노인인력개발센터,40134,1172,243,1062,243,110,47
노인인력개발센터,40745,203,1252,190,1252,13,48
녹청자박물관,42668,2631,466,2573,466,58,103
녹청자박물관,42669,181,1955,181,1955,0,71
논고개길,39687,1939,2690,1902,2690,37,154
논고개길,39819,2268,1914,2256,1914,12,139
논고개길사거리,39870,495,4,482,4,13,16
논골,35318,2,13,2,13,0,0
논골,35394,28,5,26,5,2,1
논골,44098,1,2,1,2,0,0
논골,44163,2,34,2,34,0,1
논골경로당 입구,35770,7,1,7,1,0,0
논골경로당 입구,35771,2,29,2,29,0,1
논현10단지별빛마을웰카운티A정문,39121,5315,2718,5280,2718,35,267
논현10단지별빛마을웰카운티A후문,39599,775,1620,752,1620,23,79
논현12단지산뒤마을,39609,5950,12485,5917,12485,33,614
논현13단지푸르네마을,39611,3845,6803,3812,6803,33,354
논현13단지푸르네마을,39617,4508,2181,4508,2181,0,222
논현13단지푸르네마을,39618,1460,2518,1460,2518,0,132
논현14단지등대마을,39610,10087,1534,9949,1534,138,387
논현14단지등대마을휴먼시아아파트,39612,9361,4208,9235,4208,126,452
논현1동행정복지센터,39598,1571,800,1539,800,32,79
논현2단지범마을,39625,3200,10937,3111,10937,89,471
논현2동행정복지센터,39571,1029,218,1024,218,5,41
논현2동행정복지센터,39572,176,983,165,983,11,38
논현2동행정복지센터,39636,1355,3308,1324,3308,31,155
논현2동행정복지센터,39697,3022,1477,2994,1477,28,149
논현3단지하늘마을301동,39631,96,3425,81,3425,15,117
논현3단지하늘마을302동,39624,17432,5649,17240,5649,192,769
논현3단지하늘마을305동,39626,2367,5975,2336,5975,31,278
논현3단지하늘마을305동,39627,4599,2527,4561,2527,38,237
논현5단지달맞이마을,39079,10049,3147,9715,3147,334,439
논현6단지어진마을한화꿈에그린A정문,39078,3815,7042,3725,7042,90,361
논현8단지동산마을,39104,4359,2055,4336,2055,23,213
논현8단지동산마을,39569,568,690,568,690,0,41
논현8단지동산마을,39570,395,563,390,563,5,31
논현9단지냇마을신영지웰A,39101,2094,3741,2062,3741,32,194
논현9단지냇마을신영지웰A,39602,320,182,311,182,9,16
논현9단지냇마을신영지웰A,39603,48,773,46,773,2,27
논현9단지냇마을신영지웰A정문,39600,2219,1087,2156,1087,63,110
논현고잔동행정복지센터,39707,7681,12963,7536,12963,145,688
논현단풍마을트리플에듀,39582,3596,5430,3575,5430,21,300
논현단풍마을트리플에듀,39616,374,231,373,231,1,20
논현동힐스테이트,39708,19995,9521,19747,9521,248,983
논현사거리,39504,5305,4367,5228,4367,77,322
논현사거리,39505,4187,4497,4143,4497,44,289
논현센트럴뷰·에코메트로5단지,39693,733,919,677,919,56,55
논현신일해피트리아파트,39088,2131,7194,2116,7194,15,310
논현신일해피트리아파트,39089,7020,2637,6843,2637,177,321
논현역,32007,74,3194,74,3194,0,108
논현역,32008,4034,57,4027,57,7,136
논현유승한내들,39839,1558,2751,1547,2751,11,143
논현유승한내들,39923,3160,1023,3112,1023,48,139
논현주공1단지,39112,14370,7369,14227,7369,143,724
논현주공2단지,39106,12037,13225,11784,13225,253,842
논현주공아파트(인천금융고),39096,12550,10947,12446,10947,104,783
논현주공아파트(인천금융고),39098,15786,12933,15655,12933,131,957
논현중앙공원·남동논현도서관,39604,446,1941,443,1941,3,79
논현중학교,39573,1332,214,1332,214,0,51
논현중학교,39574,118,639,118,639,0,25
논현초등학교,39601,832,1951,771,1951,61,92
논현파크포레,39649,5627,3469,5506,3469,121,303
논현파크포레,39722,1518,3721,1478,3721,40,174
논현포대근린공원,92056,66,46,66,46,0,3
논현푸르지오.유호엔시티,39822,2764,174,2718,174,46,97
논현화훼단지,39830,182,1339,165,1339,17,50
논현화훼단지,39831,263,715,258,715,5,32
농기계은행앞,90036,0,16,0,16,0,0
농기계은행앞,90037,16,0,16,0,0,0
농도원,43178,76,54,75,54,1,4
농도원,43355,126,54,122,54,4,6
농막골,90189,4,3,4,3,0,0
농막골,90190,9,5,2,5,7,0
농산물시장,40688,4144,1463,4048,1463,96,186
농어바위캠핑장,44140,13,8,10,8,3,0
농어바위캠핑장,44164,25,26,25,26,0,1
농어촌공사앞,43268,149,21,140,21,9,5
농어촌공사앞,43489,27,111,18,111,9,4
농업기술센터,43357,186,126,171,126,15,10
농업기술센터,43573,61,194,58,194,3,8
농장주유소,39472,335,1056,331,1056,4,46
농장주유소,39508,202,668,202,668,0,29
농협로타리,40244,1207,2724,1207,2724,0,131
농협로타리,40248,2530,1467,2469,1467,61,133
농협로타리,40251,1332,2508,1323,2508,9,128
농협로타리,40751,4237,2707,4177,2707,60,231
농협하나로마트,44117,3,0,1,0,2,0
농협하나로마트,44165,1,8,1,8,0,0
높은마을입구,35685,52,64,48,64,4,3
높은마을입구,35693,75,38,75,38,0,3
누촌,43238,71,139,64,139,7,7
누촌,43360,146,63,123,63,23,6
뉴그린아트빌,40875,1060,856,1040,856,20,63
뉴그린아트빌,40876,392,1650,381,1650,11,68
뉴서울1차아파트,40275,13714,81,13544,81,170,459
뉴서울3차아파트,41026,1865,3990,1849,3990,16,195
뉴서울3차아파트,41029,8967,1352,8866,1352,101,343
뉴서울3차아파트,41032,1713,5106,1673,5106,40,227
뉴서울6차아파트,41632,1598,351,1590,351,8,64
뉴서울6차아파트,41635,498,1808,490,1808,8,76
뉴서울아파트,38303,1456,1506,1439,1506,17,98
뉴서울아파트,39234,8609,172,8537,172,72,292
뉴서울아파트,39235,257,4733,250,4733,7,166
뉴서울아파트,40505,2459,1081,2402,1081,57,118
뉴서울아파트,40514,690,458,668,458,22,38
뉴서울아파트,40526,2206,4272,2182,4272,24,215
뉴서울아파트,41153,6383,6566,6374,6566,9,431
뉴서울아파트,89071,6886,17594,6623,17594,263,816
느티나무,43182,9,91,6,91,3,3
느티나무,43232,67,17,64,17,3,2
늘목,35414,79,447,79,447,0,17
늘목,35415,340,78,340,78,0,13
늘목마을입구,35529,13,48,13,48,0,2
늘목마을입구,35725,31,3,31,3,0,1
늘푸른벽산.서강2차,70021,66,2488,18,2488,48,85
능곡마을회관,43553,64,7,53,7,11,2
능곡마을회관,43649,25,49,24,49,1,2
능미,43921,42,4,41,4,1,1
능미,43922,4,46,3,46,1,1
능안,43276,105,69,100,69,5,5
능안,43571,21,80,21,80,0,3
능촌삼거리,90370,1,7,1,7,0,0
능촌입구,43560,14,3,14,3,0,0
능촌입구,43854,0,26,0,26,0,0
능허대공원,38567,349,715,344,715,5,35
다남동소촌마을입구,41329,606,14,599,14,7,20
다남동소촌마을입구,41330,2,707,2,707,0,23
다남동역골입구,41333,0,105,0,105,0,3
다남동역골입구,41334,93,5,88,5,5,3
다남성결교회,41664,93,39,92,39,1,4
다남성결교회,41665,3,138,3,138,0,4
다남식당,41477,2199,14135,2180,14135,19,544
다남식당,41478,774,3639,753,3639,21,147
다리목,43717,11,9,10,9,1,0
다리목,43845,6,9,5,9,1,0
다우리농장,44083,5,0,5,0,0,0
다우리농장,44166,0,2,0,2,0,0
다운,43605,69,90,66,90,3,5
다운,43822,183,107,175,107,8,9
다운1리,43582,33,88,32,88,1,4
다운1리,43821,57,23,52,23,5,2
다운마을,43398,3,74,3,74,0,2
다운마을,43824,97,1,95,1,2,3
다임메가타운,40870,51,536,50,536,1,19
단봉초등학교,42380,3768,644,3660,644,108,147
단봉초등학교,42382,767,3065,727,3065,40,127
달빛축제공원,38620,33,194,31,194,2,7
달빛축제공원,38621,145,454,141,454,4,19
달빛축제공원대공연장,38733,354,851,348,851,6,40
달빛축제공원대공연장,38734,1147,421,1134,421,13,52
담방로사거리,39275,12129,4020,11990,4020,139,538
담방아파트,39226,572,99,561,99,11,22
당곡고개,80048,116,624,116,624,0,24
당곡고개,80049,682,45,680,45,2,24
당미마을,41552,4489,6286,4469,6286,20,359
당미마을,41553,4642,3292,4560,3292,82,264
당산리,43450,6,111,5,111,1,3
당산리,43700,113,5,105,5,8,3
당산리검문소,43699,163,14,152,14,11,5
당산리검문소,43752,4,135,4,135,0,4
당산종점,43669,5,29,5,29,0,1
당산종점,43725,36,4,31,4,5,1
당산초등학교,41418,5827,3162,5772,3162,55,299
당산초등학교,41419,2194,3200,2185,3200,9,179
당산초등학교아래사거리,41644,25,164,25,164,0,6
당산초등학교아래사거리,41645,560,325,557,325,3,29
당하금호어울림1차,42435,128,294,124,294,4,14
당하농원,42388,4,6,4,6,0,0
당하농원,42390,6,163,2,163,4,5
당하대주파크빌,42392,1616,1126,1582,1126,34,91
당하동탑스빌아파트,42639,4098,2675,4018,2675,80,225
당하동행정복지센터,42886,8857,4345,8672,4345,185,440
당하마트,42618,18,26,18,26,0,1
당하마트,42619,9,121,7,121,2,4
당하메디칼,42402,1541,1812,1521,1812,20,111
당하초등학교,42396,1622,711,1597,711,25,77
당하초등학교,42399,1065,1434,1039,1434,26,83
당하탑스빌아파트,42393,2085,2684,2040,2684,45,158
당하푸르지오,42403,1119,779,1092,779,27,63
당하푸르지오,42502,293,3080,288,3080,5,112
당하풍림아파트,42405,2193,9961,2172,9961,21,405
대경화성,39789,996,784,994,784,2,59
대경화성,39790,1021,1621,1016,1621,5,88
대곶사거리,80008,1500,5390,1436,5390,64,229
대곶사거리,80009,6405,1459,6251,1459,154,262
대기이에스티,39013,281,300,281,300,0,19
대덕강업앞,42759,9,499,9,499,0,16
대동1차후문(종점),40553,326,771,320,771,6,36
대동도어(주),39983,467,37,467,37,0,16
대동도어(주),39984,6,576,6,576,0,19
대동아파트,37042,7681,2098,7595,2098,86,325
대동아파트,37504,4147,6656,4085,6656,62,360
대동아파트,38128,6346,10933,6226,10933,120,575
대동아파트,38345,5488,5660,5388,5660,100,371
대동아파트,39256,433,5111,423,5111,10,184
대동아파트,39473,4208,176,4135,176,73,146
대동아파트,39474,103,7275,86,7275,17,245
대동아파트,40491,766,272,750,272,16,34
대동아파트,40569,8357,3212,8109,3212,248,385
대동아파트,41172,2732,698,2664,698,68,114
대동아파트,42304,2554,4273,2497,4273,57,227
대동아파트,42306,3154,1984,3107,1984,47,171
대동아파트정문앞,40277,1354,784,1323,784,31,71
대동아파트후문,41137,2330,4591,2315,4591,15,230
대동월드,38116,4832,2787,4660,2787,172,253
대동특수철강,39049,111,1247,111,1247,0,45
대룡2리마을회관앞,90026,4,44,4,44,0,1
대룡2리마을회관앞,90027,41,1,40,1,1,1
대룡시장,90020,348,1280,347,1280,1,54
대룡시장,90021,1271,356,1213,356,58,54
대륭맨숀,40242,8631,5774,8568,5774,63,480
대륭맨숀,40247,9371,9878,9273,9878,98,641
대림3차아파트301동앞,38681,202,28,201,28,1,7
대림3차아파트301동앞,38684,28,630,27,630,1,21
대림아파트,37053,10744,4308,10534,4308,210,501
대림아파트,37054,3058,7505,2985,7505,73,352
대림아파트,38257,5126,1631,5088,1631,38,225
대림아파트,40382,3525,11135,3476,11135,49,488
대림아파트,42609,1779,1566,1630,1566,149,111
대림아파트,42610,202,1835,190,1835,12,67
대림아파트후문,40397,2007,1366,1935,1366,72,112
대명아파트,37537,2312,6875,2312,6875,0,306
대명초교,80002,1756,144,1691,144,65,63
대명초교,80003,310,1639,298,1639,12,64
대문리고개입구,43546,615,280,555,280,60,29
대문목재,89206,12,62,9,62,3,2
대문목재,89207,262,10,254,10,8,9
대문촌마을,90058,1,6,1,6,0,0
대문촌마을,90059,2,0,2,0,0,0
대박주유소,36091,2316,2412,2282,2412,34,157
대부고교차로,18388,1,6,1,6,0,0
대부관광호텔,62040,307,57,305,57,2,12
대부도서관,18389,0,12,0,12,0,0
대부도서관,18391,1,14,1,14,0,0
대부동행정복지센터,62011,339,1401,311,1401,28,58
대부동행정복지센터,62012,1245,252,1227,252,18,49
대부중고등학교,62027,375,78,372,78,3,15
대부중고등학교,62028,56,343,51,343,5,13
대부파출소앞,62036,2,119,2,119,0,4
대부파출소앞,62042,105,4,101,4,4,3
대사마을,43947,16,218,16,218,0,7
대사마을,43948,204,17,193,17,11,7
대산-기점,90259,1665,1618,1652,1618,13,109
대상스틸,89007,37,604,33,604,4,21
대성베르힐아파트(가정성당),89240,1716,3026,1646,3026,70,158
대성베르힐아파트(가정성당),89241,5632,2521,5582,2521,50,271
대성유니드아파트,40674,1093,3839,1052,3839,41,164
대성유니드아파트,40675,2104,370,2079,370,25,82
대신아파트,41406,6119,1851,6095,1851,24,265
대신철강,42859,32,1206,22,1206,10,41
대야초교.ABC학습타운입구,70017,205,1649,192,1649,13,61
대야초교.ABC학습타운입구,70020,1904,456,1860,456,44,78
대양자동차학원,35073,19,2552,12,2552,7,85
대우삼환아파트,38078,6447,4449,6314,4449,133,363
대우삼환아파트,38591,1521,3366,1501,3366,20,162
대우실업,41485,32,23,32,23,0,1
대우실업,41505,32,1,30,1,2,1
대우아파트,38206,3910,4019,3793,4019,117,264
대우아파트,38208,4245,2753,4122,2753,123,233
대우아파트,40321,194,438,174,438,20,21
대우아파트,40340,880,527,852,527,28,46
대우일렉트로닉스,37462,90,1720,67,1720,23,60
대우일렉트로닉스,37463,747,528,735,528,12,42
대우자동차운전학원,42262,270,183,264,183,6,15
대우자동차운전학원,42263,128,328,125,328,3,15
대우재아파트,39702,14,397,11,397,3,13
대우재아파트,39703,486,424,484,424,2,30
대우푸르지오,42407,24308,7150,23833,7150,475,1048
대우푸르지오,42842,898,3764,843,3764,55,155
대우푸르지오복합상가,39605,2866,1896,2756,1896,110,158
대우하나아파트,89073,17868,8355,17687,8355,181,874
대우하나아파트,89074,6962,11148,6891,11148,71,603
대웅실업앞,92003,42,380,42,380,0,14
대원레스피아1단지아파트,42643,8675,34,8468,34,207,290
대원정밀,39475,454,750,452,750,2,40
대월초등학교,90094,0,5,0,5,0,0
대월초등학교,90095,6,0,6,0,0,0
대은교회,42143,4981,10997,4795,10997,186,532
대인고등학교,42344,2835,2127,2784,2127,51,165
대인고등학교,42345,3317,1828,3258,1828,59,171
대일엠앤쿡,39059,799,2191,799,2191,0,99
대장간마을,43703,321,127,290,127,31,14
대정,90117,14,62,12,62,2,2
대정,90118,38,26,29,26,9,2
대주아파트,42469,1526,10421,1466,10421,60,398
대주파크빌,42466,5524,1295,5281,1295,243,227
대진아파트,40415,2302,2766,2284,2766,18,168
대촌,43393,67,71,61,71,6,4
대촌,43545,25,20,25,20,0,1
대촌마을,41663,18,4,18,4,0,0
대토단지앞,39813,1362,32,1319,32,43,46
대한솔루션알앤디센터,39557,26,264,26,264,0,9
대한제당,35169,1473,66,1462,66,11,51
대한제당,35220,18,1760,18,1760,0,59
대현목재,89205,175,41,173,41,2,7
대화초등학교,37397,6702,2701,6654,2701,48,313
대화초등학교,37399,3156,4667,3112,4667,44,260
대흥,43194,13,283,12,283,1,9
대흥,43591,368,16,348,16,20,12
대흥식당,35688,55,34,51,34,4,2
대흥식당,35689,19,54,17,54,2,2
더리미경로당,43363,32,16,28,16,4,1
더리미경로당,43731,15,32,13,32,2,1
더리미미술관,43961,79,32,65,32,14,3
더리미미술관,43962,16,3,14,3,2,0
더리미장어마을,43680,21,34,18,34,3,1
더리미장어마을,43864,25,17,24,17,1,1
더샵그린스퀘어105동,92021,1323,111,1321,111,2,47
더샵그린스퀘어107동,92022,107,1706,107,1706,0,60
더샵그린애비뉴,38486,6110,7788,5888,7788,222,463
더샵그린애비뉴,38510,671,875,642,875,29,51
더샵그린애비뉴,38511,976,478,938,478,38,48
더샵그린워크1단지,38495,5500,2245,5395,2245,105,258
더샵부평센트럴시티(101동),40061,1505,2487,1497,2487,8,133
더샵부평센트럴시티(101동),40065,2509,1363,2501,1363,8,129
더샵부평센트럴시티(127동),40050,8878,12500,8783,12500,95,712
더샵센트럴시티204동,92020,93,1613,93,1613,0,56
더샵센트럴시티205동,92019,4283,2967,4236,2967,47,241
더샵송도프라임뷰20단지,38561,1563,2489,1511,2489,52,135
더샵엑스포빌리지,38480,8013,2961,7896,2961,117,365
더샵퍼스트파크13단지,38601,1191,189,1136,189,55,46
더샵퍼스트파크13단지,38602,144,658,139,658,5,26
더샵하버뷰,38485,10161,5276,9972,5276,189,514
더샵하버뷰,38487,3460,2615,3421,2615,39,202
더샵하버뷰(D13),38453,487,523,443,523,44,33
더샵하버뷰(D13),38466,675,788,664,788,11,48
더샵하버뷰(D14),38454,280,235,273,235,7,17
더샵하버뷰14단지,38504,1305,780,1291,780,14,69
더월드스테이트2단지,37657,857,426,837,426,20,42
더월드스테이트후문,37422,41,732,41,732,0,25
더포레스트아파트,39876,14424,2019,14395,2019,29,548
더포레스트아파트,39877,4631,11260,4612,11260,19,529
더프라우,38410,7790,21428,7530,21428,260,973
더필립요양병원,40461,2085,3815,2070,3815,15,196
덕고개삼거리,43723,31,57,29,57,2,2
덕고개삼거리,43750,10,41,10,41,0,1
덕골,43397,18,5,17,5,1,0
덕골,43399,16,21,15,21,1,1
덕교3거리,35012,155,23,154,23,1,5
덕교동,35003,762,182,752,182,10,31
덕교동,35005,77,1301,77,1301,0,45
덕교동,35259,1189,262,1189,262,0,48
덕교삼거리,35214,42,225,41,225,1,8
덕신고등학교(강화읍교회),90228,9,120,9,120,0,4
덕신고등학교(강화읍교회),90229,179,188,179,188,0,12
덕유마을.설악마을,55073,1718,712,1686,712,32,81
덕음,43657,17,25,16,25,1,1
덕응,43983,1,8,1,8,0,0
덕응,43986,15,20,14,20,1,1
덕정가든,43173,3,28,3,28,0,1
덕정가든,43296,22,3,22,3,0,0
덕진사거리,43870,43,6,42,6,1,1
덕진사거리,90310,11,16,11,16,0,0
덕진진,43637,28,135,27,135,1,5
덕진진,43672,63,7,62,7,1,2
덕창기계,39723,193,80,193,80,0,9
덕포리,43006,490,229,484,229,6,23
덕포리,43100,224,367,208,367,16,19
덕하교앞,43449,39,20,37,20,2,1
덕하교앞,43727,10,42,10,42,0,1
덕화2리,43468,48,9,47,9,1,1
덕화2리,43730,3,30,3,30,0,1
덕화2리마을회관,43923,28,23,26,23,2,1
덕화2리마을회관,43924,2,21,2,21,0,0
덕화3리마을회관,43609,136,88,132,88,4,7
덕화3리입구,43469,9,6,9,6,0,0
덕화3리입구,43729,17,30,16,30,1,1
덕화교회앞,90398,1,19,1,19,0,0
덕화교회앞,90399,4,4,4,4,0,0
도간마을,43612,34,0,34,0,0,1
도간마을,43664,0,38,0,38,0,1
도감말,43733,26,9,23,9,3,1
도감말,43754,9,12,9,12,0,0
도곡한신아파트,23504,49,71,49,71,0,4
도담공원.푸르지오더베뉴,89397,2787,932,2769,932,18,123
도담공원.푸르지오더베뉴,89398,3176,3785,3083,3785,93,232
도두리마을,41565,12821,1455,12780,1455,41,475
도두리마을,41566,1939,11305,1935,11305,4,441
도림동고개,39160,1357,630,1343,630,14,66
도림동고개,39161,509,1517,502,1517,7,67
도림동입구,39140,7762,1557,7748,1557,14,310
도림동입구,39141,18,2541,13,2541,5,85
도림아이파크아파트,39155,7181,3556,7099,3556,82,357
도림육교,39154,2987,5993,2943,5993,44,299
도림주공1단지,39152,14941,12102,14764,12102,177,901
도림주공1단지,39153,14731,10157,14516,10157,215,829
도림주공208동,39142,7205,3316,7063,3316,142,350
도림주공208동,39143,5046,7651,4991,7651,55,423
도림주공2단지,39146,4671,4212,4630,4212,41,296
도림주공2단지,39149,3688,2561,3615,2561,73,208
도림주철관1공장,89307,296,448,295,448,1,24
도림주철관공업(주),42293,3286,1041,3274,1041,12,144
도림포도원,39150,313,3646,307,3646,6,131
도림포도원,39151,498,450,495,450,3,31
도원고개(도원역),36001,4696,3401,4522,3401,174,269
도원고개(동구청방향),36170,22,50,22,50,0,2
도원동행정복지센터,35180,3319,2823,3210,2823,109,204
도원동행정복지센터,36128,63,231,62,231,1,9
도원동행정복지센터(앞),35788,167,117,159,117,8,9
도원동행정복지센터(앞),35798,189,69,183,69,6,8
도원역(인천축구전용경기장),35176,10244,5287,9943,5287,301,517
도원역(인천축구전용경기장),37549,1443,4249,1417,4249,26,189
도장골삼거리,44122,6,5,4,5,2,0
도장재마을,43167,25,1,24,1,1,0
도장재마을,43225,2,23,2,23,0,0
도화1동행정복지센터,37340,13027,11483,12702,11483,325,817
도화IC,37356,26295,20785,25960,20785,335,1569
도화e편한세상604동,37578,1013,19,1000,19,13,34
도화e편한세상아파트,37612,263,1436,261,1436,2,56
도화e편한세상아파트,37613,4339,1422,4326,1422,13,192
도화e편한세상아파트5단지,37624,3516,1370,3477,1370,39,162
도화e편한세상아파트6단지,37626,2325,3569,2296,3569,29,196
도화동신협(구박문여고),36003,10615,4598,10512,4598,103,507
도화동신협(구박문여고),37499,5200,7061,5132,7061,68,408
도화사거리.도화역,37390,787,854,787,854,0,54
도화사거리.도화역,37392,383,1047,383,1047,0,47
도화서희스타힐스,37625,1262,2675,1258,2675,4,131
도화역,37629,5851,6132,5851,6132,0,399
도화초등학교.수봉도서관,37366,7427,6697,7273,6697,154,470
도화초등학교.수봉도서관,37367,12385,12596,12078,12596,307,832
독골사거리,42175,3342,1382,3296,1382,46,157
독배로317번길(삼거리),37634,7754,208,7754,208,0,265
독장골,43351,2,29,2,29,0,1
독장골,43846,8,2,7,2,1,0
독정역(서구동구예비군훈련장),42377,3452,3158,3366,3158,86,220
독정역(서구동구예비군훈련장),42378,7145,4490,7042,4490,103,387
독정이고개,37234,29999,20572,29373,20572,626,1685
독정이고개,37238,20427,26139,20012,26139,415,1552
돈대마을,43925,17,5,17,5,0,0
돈대마을,43926,7,29,7,29,0,1
돈대모루,43422,0,16,0,16,0,0
돈대모루,43447,13,13,13,13,0,0
돌고래펜션,44168,0,1,0,1,0,0
돌머루(대산종점),43707,118,123,110,123,8,8
돌산밑,35320,171,16,171,16,0,6
돌산밑,35396,30,188,30,188,0,7
돌성,43364,50,179,50,179,0,7
돌성,43587,220,11,210,11,10,7
돌팍재삼거리,35273,487,578,453,578,34,35
돌팍재삼거리,35277,737,504,716,504,21,41
돌팍재한뿌리,35304,196,250,182,250,14,14
돌팍재한뿌리,35315,151,292,151,292,0,14
동강리,35245,71,40,65,40,6,3
동강리,35246,87,68,75,68,12,5
동강리,35317,34,65,32,65,2,3
동강리,35393,120,46,116,46,4,5
동검도삼거리,43223,0,34,0,34,0,1
동검도삼거리,43642,62,1,61,1,1,2
동검리마을회관입구,90069,0,5,0,5,0,0
동검리마을회관입구,90070,14,1,14,1,0,0
동검리입구,43856,5,21,5,21,0,0
동검리입구,43877,13,2,13,2,0,0
동검리종점,43889,63,44,60,44,3,3
동검상회,43226,4,0,4,0,0,0
동검상회,43519,0,4,0,4,0,0
동광리어,41083,1298,456,1266,456,32,58
동광리어,41084,750,2283,740,2283,10,101
동광제일교회,40411,508,445,504,445,4,31
동교동삼거리,22012,7474,57,7459,57,15,251
동교동삼거리,23033,116,5498,113,5498,3,187
동구노인인력개발센터,36178,3,6,3,6,0,0
동구선거관리위원회,36110,4302,10941,4228,10941,74,508
동구청,36011,608,589,598,589,10,39
동구청,36166,8,23,8,23,0,1
동구청소년수련관.달동네박물관,36026,19065,15798,18589,15798,476,1162
동구환경,36181,0,1,0,1,0,0
동국제강,36068,2269,3348,2227,3348,42,187
동국제강,36074,281,138,275,138,6,13
동국제강후문,36069,239,659,227,659,12,29
동국제강후문,36070,999,160,988,160,11,38
동남스포피아,38226,10695,6918,10534,6918,161,587
동남스포피아,38227,10542,9275,10263,9275,279,660
동남아파트,38267,960,5138,923,5138,37,203
동남아파트,38268,2414,948,2338,948,76,112
동남아파트,70039,508,752,502,752,6,42
동남아파트(무지개아파트),38337,1468,4268,949,4268,519,191
동녘개,90147,1,12,1,12,0,0
동녘개,90148,43,11,42,11,1,1
동녘마을입구,39660,58,950,58,950,0,33
동들머리,43705,23,8,22,8,1,1
동들머리,43885,171,218,164,218,7,12
동막교회,43499,5,49,4,49,1,1
동막교회,43514,86,0,73,0,13,2
동막역(1번출구),38039,36697,51905,36523,51905,174,2953
동막역(3번출구),38433,50161,28446,49880,28446,281,2620
동막역(4번출구),38338,8836,1247,8823,1247,13,336
동막초등학교,38054,873,4333,867,4333,6,173
동막해변,43408,69,216,65,216,4,9
동막해변,43511,370,101,361,101,9,15
동문아파트,42436,13451,14673,13255,14673,196,937
동방중학교,92038,280,414,259,414,21,23
동방초등학교,92037,31,124,25,124,6,5
동보2차아파트,41053,37,620,36,620,1,21
동보2차아파트,41059,898,120,891,120,7,33
동보노빌리티,35488,3325,2012,3251,2012,74,177
동보노빌리티,35489,1825,2851,1782,2851,43,155
동보아파트,39125,3473,5462,3427,5462,46,297
동보아파트,39126,5560,1905,5556,1905,4,248
동보아파트,41056,4141,503,4052,503,89,154
동보아파트,41063,788,3673,757,3673,31,148
동보아파트,41136,295,1238,294,1238,1,51
동보아파트,41143,13714,15853,13535,15853,179,985
동보아파트,70040,507,566,481,566,26,35
동보아파트후문,41129,1474,245,1458,245,16,57
동부아파트,36052,1446,2647,1377,2647,69,136
동부아파트,37192,490,431,472,431,18,30
동산고,36018,11590,3875,11350,3875,240,515
동산고등학교,36021,5406,11369,5278,11369,128,559
동산교회,36010,2149,3030,2097,3030,52,172
동산교회,36012,3346,4824,3260,4824,86,272
동산교회,90303,1,0,1,0,0,0
동산리마을회관,90302,20,7,19,7,1,0
동산리입구,90291,3,1,3,1,0,0
동산리입구,90299,1,1,1,1,0,0
동산중고등학교(재능대정문),36029,9612,1023,9580,1023,32,354
동산휴먼시아2단지,36022,2955,499,2941,499,14,115
동산휴먼시아2단지,36023,917,4135,912,4135,5,168
동산휴먼시아2단지정문,36177,13,15,13,15,0,0
동서식품,40623,2440,2458,2420,2458,20,163
동서식품,40624,2084,3490,2062,3490,22,185
동성.길훈아파트,42495,3070,5011,3038,5011,32,269
동성아파트,42496,4285,2063,4251,2063,34,211
동수교회,40184,171,1316,143,1316,28,49
동수역,40108,3110,6189,3075,6189,35,309
동수역,40110,7775,6199,7657,6199,118,465
동수역,40124,2208,12877,2133,12877,75,502
동수치안센터,40188,9373,8963,9188,8963,185,611
동수치안센터,40189,11136,12491,10945,12491,191,787
동아.팬더아파트,39233,6915,9316,6853,9316,62,541
동아.팬더아파트,39236,9926,5793,9833,5793,93,523
동아2단지정문,40324,1441,458,1400,458,41,63
동아금호아파트,38344,4929,11665,4844,11665,85,553
동아금호아파트,38347,6909,2546,6852,2546,57,315
동아아파트,37248,926,1173,912,1173,14,69
동아아파트,41070,3223,763,3138,763,85,132
동아아파트,41072,757,2715,726,2715,31,115
동아아파트,41403,900,4111,899,4111,1,167
동아아파트,42404,3315,4032,3212,4032,103,244
동아아파트,42406,5700,3076,5556,3076,144,292
동아아파트후문,40257,2160,2519,2092,2519,68,155
동아아파트후문,40258,2187,1734,2159,1734,28,130
동아전기,42647,62,421,62,421,0,16
동아전기,42725,72,425,66,425,6,16
동아정밀,42037,1405,2634,1398,2634,7,134
동아풍림아파트,37037,15003,17793,14570,17793,433,1093
동암국민주택,40014,3231,860,3160,860,71,136
동암국민주택,40015,776,1940,755,1940,21,90
동암남부역,40034,42560,28871,42021,28871,539,2381
동암남부역,40797,130817,112781,129813,112781,1004,8119
동암남부역,40861,876,6388,870,6388,6,242
동암남부역,40862,17679,14234,17441,14234,238,1063
동암마트,40039,152,2045,133,2045,19,73
동암북부역,40013,33717,16211,33301,16211,416,1664
동암북부역,40035,10568,31889,10425,31889,143,1415
동암북부역광장,40800,67984,53478,67395,53478,589,4048
동암사거리,40001,13568,15691,13494,15691,74,975
동암사거리,40003,3414,5635,3381,5635,33,301
동양도서관,41522,7309,4014,7255,4014,54,377
동양도서관(휴먼빌아파트),41523,4087,5420,4060,5420,27,316
동양엔파트4단지,42820,2042,4640,1926,4640,116,222
동양엔파트4단지,42837,4002,1699,3958,1699,44,190
동양엔파트5단지,42986,2586,2823,2435,2823,151,180
동양자이입구,41554,3303,4293,3266,4293,37,253
동양자이입구,41555,3771,3170,3747,3170,24,231
동양장사거리,37301,7842,6058,7766,6058,76,463
동양주공1.2단지,41372,12528,3457,12325,3457,203,532
동양주공1.2단지,41373,2963,7817,2913,7817,50,359
동양지구1단지정문,41521,718,2450,716,2450,2,105
동양지구입구,41445,5441,621,5363,621,78,202
동양지구입구,41446,1382,7172,1369,7172,13,285
동양하이테크,42966,24,229,24,229,0,8
동원아파트,25166,274,280,272,280,2,18
동원아파트,25167,287,106,276,106,11,13
동원아파트,37376,4991,2173,4891,2173,100,238
동원아파트,37379,1777,3320,1728,3320,49,169
동인천,35188,30830,36020,30453,36020,377,2228
동인천(우리은행앞),35517,818,459,798,459,20,42
동인천동행정복지센터,35795,42,392,39,392,3,14
동인천동행정복지센터,35805,68,172,64,172,4,8
동인천역,35185,103513,51497,101813,51497,1700,5167
동인천역,35187,5432,9699,5286,9699,146,504
동인천역,35191,76098,88667,74876,88667,1222,5492
동인천역,35192,10735,22181,10335,22181,400,1097
동인천역북광장,36136,26717,17627,26315,17627,402,1478
동인천역북광장,36137,28821,16438,28320,16438,501,1508
동인천중학교,39229,1602,943,1588,943,14,84
동인천중학교,39230,1820,1268,1780,1268,40,102
동일방직,36031,3871,3562,3814,3562,57,247
동일방직,36032,3798,2610,3744,2610,54,213
동일아파트,35177,449,1661,343,1661,106,70
동작세무서,20005,19,307,19,307,0,10
동주농장,43349,4,8,4,8,0,0
동주농장,43401,24,2,22,2,2,0
동촌,43407,115,0,112,0,3,3
동촌,43793,9,98,9,98,0,3
동춘2동행정복지센터,38045,1172,6031,1096,6031,76,240
동춘2동행정복지센터,38046,5990,691,5826,691,164,222
동춘동종점,38037,279,864,211,864,68,38
동춘동차고지,38569,558,321,469,321,89,29
동춘롤러경기장,38704,337,467,308,467,29,26
동춘마을아파트,38082,6690,4662,6601,4662,89,378
동춘마을아파트,38087,3024,6667,2964,6667,60,323
동춘역,38346,29228,19795,29062,19795,166,1634
동춘역(이마트),38060,12496,687,12465,687,31,439
동춘역(이마트.스퀘어원),38070,27835,35063,27698,35063,137,2096
돼지슈퍼.간동입구,80019,85,854,81,854,4,31
두두미마을,43289,10,0,10,0,0,0
두두미마을,43869,0,8,0,8,0,0
두밀경노당,89328,13,127,13,127,0,4
두밀경노당,89331,112,0,110,0,2,3
두산아파트,40564,2105,3753,1961,3753,144,195
두산위브아파트,37043,14724,8642,14503,8642,221,778
두산위브아파트,40630,10156,503,10051,503,105,355
두산위브아파트,40648,371,1089,362,1089,9,48
두운1리마을회관앞,90047,4,34,4,34,0,1
두운1리마을회관앞,90048,26,2,26,2,0,0
두운리,43034,0,19,0,19,0,0
두운리,43540,85,174,81,174,4,8
둑실경로당,41498,3,26,3,26,0,0
둑실경로당,41514,34,1,34,1,0,1
둑실동(아라마루전망대),41494,31,551,31,551,0,19
둑실동(아라마루전망대),41512,809,10,806,10,3,27
둑실동회차지,41500,71,55,71,55,0,4
둥개마을오거리,35861,24,7,24,7,0,1
둥개마을오거리,35862,14,5,14,5,0,0
둥깨마을입구(세븐일레븐),35721,8,70,8,70,0,2
둥깨마을입구(세븐일레븐),35722,55,5,45,5,10,2
둥깨마을입구(용성철강),35723,0,3,0,3,0,0
둥깨마을입구(용성철강),35724,58,0,57,0,1,1
뒤골입구,35668,30,1,30,1,0,1
뒤골입구,35669,1,26,1,26,0,0
뒷골 입구,90377,11,57,11,57,0,2
뒷골 입구,90380,57,0,57,0,0,1
뒷방죽들,39959,590,26,580,26,10,20
뒷방죽들,39960,6727,7713,6679,7713,48,481
드라이빙센터,35589,39,1143,39,1143,0,39
드림로갈산교,41342,112,58,109,58,3,5
드림로갈산교,41343,86,530,86,530,0,20
드림파크야생화단지,89363,1323,18,1151,18,172,44
드림파크야생화단지,89364,169,1090,9,1090,160,41
드림파크어울림,89201,2,19,2,19,0,0
드림파크어울림,89202,0,1,0,1,0,0
드무리해변,44011,25,598,21,598,4,20
드무리해변,44012,530,42,527,42,3,19
디에스솔텍,39035,2991,2241,2964,2241,27,174
디에스솔텍,39038,2317,2155,2315,2155,2,149
디에트로더힐,89455,1908,867,1895,867,13,92
디에트로더힐,89464,20,27,20,27,0,1
디에트르더힐(고산터널),89396,1139,1921,1126,1921,13,102
뗏마루어린이공원·신화아파트,39405,4913,6937,4801,6937,112,395
라이크홈기숙사앞,39993,1844,907,1833,907,11,91
라이크홈기숙사앞,39994,1853,1614,1853,1614,0,115
라이크홈기숙사앞,39995,1297,92,1284,92,13,46
라이크홈기숙사앞,39996,86,786,69,786,17,29
라이프쇼핑앞,35070,6396,4422,6194,4422,202,360
라이프아파트,35060,130,4911,117,4911,13,168
라이프아파트,35062,11947,133,11673,133,274,402
래미안아파트파이낸셜뉴스,31072,8900,8077,8886,8077,14,565
래미안아파트파이낸셜뉴스,32002,3519,1406,3514,1406,5,164
랜드마크시티센트럴더샵,38636,51,2293,51,2293,0,78
랜드마크시티센트럴더샵(106동),38665,834,6558,816,6558,18,246
랜드마크시티센트럴더샵(106동),38666,6054,590,5939,590,115,221
랜드마크시티센트럴더샵(203동),38645,7928,580,7832,580,96,283
랜드마크시티센트럴더샵(203동),38650,700,6714,681,6714,19,247
럭키아파트,23488,233,107,233,107,0,11
럭키아파트,38115,4283,155,4174,155,109,147
럭키아파트,38132,1338,8852,1319,8852,19,339
레이크파크,42840,1356,4335,1289,4335,67,189
레전드호텔,35639,2041,1595,2025,1595,16,121
레전드호텔,35640,4,498,3,498,1,16
레지던스라이크홈,92012,351,4150,351,4150,0,150
로봇랜드입구,89022,3165,59,3121,59,44,107
로봇랜드입구,89023,5,1748,2,1748,3,58
로봇타워,89301,7,355,5,355,2,12
로봇타워,89302,816,64,689,64,127,29
로얄금속,40599,5719,3587,5688,3587,31,310
로얄아파트,37247,32022,14720,31629,14720,393,1558
로얄아파트,37424,578,315,564,315,14,29
로얄타운,42047,1537,2481,1504,2481,33,133
로얄호텔,43542,4,24,4,24,0,0
로얄호텔,43878,27,20,27,20,0,1
롯데마트,35108,3265,4650,3173,4650,92,263
롯데마트,41390,940,47,924,47,16,32
롯데마트,41391,70,2077,54,2077,16,71
롯데마트,42829,16538,8279,16454,8279,84,827
롯데마트,42838,7571,17416,7474,17416,97,832
롯데마트계양점(고용복지센터),41227,28839,17886,28499,17886,340,1557
롯데마트계양점(고용복지센터),41424,10112,19740,10056,19740,56,995
롯데마트송도점,38523,2199,737,2179,737,20,97
롯데몰.김포공항,25174,293,1311,293,1311,0,53
롯데백화점(인천터미널),37513,177804,164453,175729,164453,2075,11408
롯데백화점(인천터미널),39588,166740,119321,164383,119321,2357,9535
롯데슈퍼,38072,7889,2731,7820,2731,69,354
롯데슈퍼,38074,2349,7265,2326,7265,23,320
롯데슈퍼,42206,2713,4332,2649,4332,64,234
롯데슈퍼,42207,6970,2428,6827,2428,143,313
롯데아파트,38110,6296,8973,6115,8973,181,508
롯데우람아파트,42152,4534,6528,4496,6528,38,368
롯데우람아파트,42603,3349,5357,3306,5357,43,290
롯데월드타워,37327,2906,5310,2812,5310,94,273
롯데캐슬,39795,346,224,338,224,8,19
롯데캐슬,39796,2058,879,2031,879,27,97
롯데캐슬,39797,363,80,361,80,2,14
롯데캐슬,39798,71,348,71,348,0,13
롯데캐슬,42835,7159,4997,7101,4997,58,405
롯데캐슬,42884,4637,9588,4421,9588,216,474
롯데캐슬,42999,922,3078,876,3078,46,133
롯데캐슬.모래내시장,39309,56859,21720,56170,21720,689,2619
롯데캐슬·모래내시장·구월시장,39310,31013,53038,30718,53038,295,2801
롯데캐슬캠퍼스타운,39977,6,650,6,650,0,21
롯데캐슬캠퍼스타운,39978,1883,2428,1857,2428,26,143
롯데캐슬후문,39285,4340,4164,4276,4164,64,283
루에블리아파트,89283,1057,3970,1008,3970,49,167
루에블리아파트,89284,6891,6848,6749,6848,142,457
루원더퍼스트아파트,89107,3422,5282,3294,5282,128,290
루원더퍼스트아파트,89108,7755,2179,7703,2179,52,331
루원더퍼스트아파트105동앞,89378,81,1169,75,1169,6,41
루원숲속마을,89383,136,442,135,442,1,19
루원숲속마을,89384,390,116,387,116,3,16
루원시티2차리더스뷰아파트,89072,3892,4671,3862,4671,30,285
루원시티사거리,89076,371,540,350,540,21,30
루원시티프라디움,89150,15792,3825,15686,3825,106,653
루원시티프라디움105동,89308,6616,10917,6423,10917,193,584
루원시티프라디움105동,89309,3036,5576,2989,5576,47,287
루원이편한세상하늘채(107동),42225,8194,15856,8062,15856,132,801
루원이편한세상하늘채(112동),42721,4864,2032,4778,2032,86,229
루원이편한세상하늘채(125동),42216,6019,2666,5862,2666,157,289
루원제일풍경채정문앞,89040,3180,9854,3125,9854,55,434
루원지웰시티푸르지오,42228,4880,6166,4717,6166,163,368
루원호반베르디움,89149,4975,12904,4858,12904,117,595
루원호반베르디움104동,89368,332,891,331,891,1,40
리안월드입구,90177,37,37,36,37,1,2
리안월드입구,90178,27,16,27,16,0,1
린나이코리아,40011,3,256,1,256,2,8
린나이코리아,40012,380,0,380,0,0,12
린스트라우스,42881,7328,2842,7149,2842,179,339
린스트라우스정문,42795,6141,3788,6108,3788,33,330
린스트리우스,42831,2538,2737,2521,2737,17,175
마그네,43028,166,180,150,180,16,11
마그네다리,43158,268,151,261,151,7,13
마그네다리,43900,17,25,15,25,2,1
마그네사거리,43029,279,300,267,300,12,19
마그네사거리,43030,534,303,510,303,24,27
마니산상회,43417,74,20,65,20,9,3
마니산상회,43443,29,74,27,74,2,3
마니산입구,43102,205,711,197,711,8,30
마니산입구,43103,935,259,930,259,5,39
마당개,35681,67,64,67,64,0,4
마당개,35697,23,10,23,10,0,1
마린월드,70004,956,183,945,183,11,37
마린월드,70029,13,139,1,139,12,5
마미,43747,53,27,52,27,1,2
마미,43765,5,16,5,16,0,0
마송,80131,743,5587,742,5587,1,211
마송,80132,3664,904,3595,904,69,152
마시란,35424,56,449,56,449,0,16
마시란,35425,337,71,335,71,2,13
마시란해변(슈퍼앞),35262,0,9,0,9,0,0
마시란해변(슈퍼앞),35263,8,0,8,0,0,0
마시란해변(전주집),35260,0,5,0,5,0,0
마시란해변(전주집),35261,30,0,30,0,0,1
마시란해변승마장,35212,13,0,13,0,0,0
마시란해변승마장,35213,0,1,0,1,0,0
마을금고,40528,1974,5554,1938,5554,36,250
마을회관,43314,38,0,38,0,0,1
마을회관,43773,0,28,0,28,0,0
마을회관입구,35024,217,1459,194,1459,23,55
마을회관입구,35402,880,116,877,116,3,33
마장공원,40286,6658,31,6588,31,70,222
마장포,35679,13,5,10,5,3,0
마장포,35699,70,51,70,51,0,4
마장포고개,35677,38,41,38,41,0,2
마장포고개,35701,58,20,55,20,3,2
마전고등학교,42752,134,7457,115,7457,19,253
마전고등학교,42753,5782,199,5629,199,153,199
마전역,42412,3075,8110,2965,8110,110,372
마전역,42413,19280,4783,19053,4783,227,802
마전주공아파트,42420,28,172,27,172,1,6
마전주공아파트,89322,0,4,0,4,0,0
마전지구대원아파트,42481,5053,74,4879,74,174,170
마전지구대원아파트,89446,9,3964,9,3964,0,132
마전지구버스차고지,89259,3888,89,3634,89,254,132
마전지구버스차고지,89345,222,2065,23,2065,199,76
마전초등학교,42408,5265,5194,5192,5194,73,348
마포역,14001,1,361,1,361,0,12
마포역,14002,221,1,221,1,0,7
막촌,43460,341,11,311,11,30,11
막촌,43776,0,134,0,134,0,4
만석동행정복지센터,36046,4100,1728,3942,1728,158,194
만석부두,36076,609,3513,571,3513,38,137
만석부두,36079,4523,1652,4471,1652,52,205
만석비치타운,36106,609,9119,564,9119,45,324
만석비치타운,36126,1556,943,1385,943,171,83
만석삼거리,36185,2725,2538,2642,2538,83,175
만석삼거리,36186,1394,2376,1385,2376,9,125
만석주공,36057,14489,2684,14130,2684,359,572
만석초등학교,36056,811,213,770,213,41,34
만석초등학교,36187,2,149,1,149,1,5
만수1동행정복지센터,39294,11955,4750,11840,4750,115,556
만수2동행정복지센터·포레시안,39731,16641,10089,16386,10089,255,891
만수2동행정복지센터·포레시안,39735,9943,12006,9843,12006,100,731
만수3동주민센터,39425,19919,26114,19675,26114,244,1534
만수3동주민센터,39427,31855,13497,31613,13497,242,1511
만수3동주민센터,39544,572,125,560,125,12,23
만수3동주민센터,39545,75,1094,72,1094,3,38
만수4동주민센터,39452,7098,6579,6980,6579,118,455
만수4동주민센터,39454,6517,12034,6422,12034,95,618
만수6동주민센터입구,39277,4721,12402,4686,12402,35,570
만수7.8단지앞,39497,888,2024,878,2024,10,97
만수7.8단지앞,39635,2589,2271,2575,2271,14,162
만수북중학교,39468,1076,1893,1046,1893,30,98
만수북중학교,39469,2120,596,2063,596,57,90
만수북초등학교,39420,6955,4853,6820,4853,135,393
만수소방서,39428,9360,16068,9271,16068,89,847
만수소방서,39433,35876,12902,35562,12902,314,1625
만수신동아아파트·동인천고,39485,10281,10338,9604,10338,677,687
만수신동아아파트·동인천고,39578,476,71,458,71,18,18
만수역,39385,3453,99,3451,99,2,118
만수역,39388,461,19097,393,19097,68,651
만수종합시장,39451,29421,9728,28792,9728,629,1304
만수종합시장,39592,9773,22180,9631,22180,142,1065
만수주공1단지,39401,3644,3542,3631,3542,13,239
만수주공320동앞,39431,1493,1812,1472,1812,21,110
만수주공4단지,39440,7705,5478,7628,5478,77,439
만수주공4단지,39443,10318,8424,10174,8424,144,624
만수주공정문,39408,10861,8536,10758,8536,103,646
만수주공정문,39410,3135,3297,3063,3297,72,214
만수주공후문,39435,4696,11602,4649,11602,47,543
만수주공후문,39438,13925,3819,13729,3819,196,591
만수중(대토단지),39400,396,1705,390,1705,6,70
만수중학교후문,39745,131,905,130,905,1,34
만수초등학교,39303,1568,5022,1528,5022,40,219
만수초등학교,39307,680,889,648,889,32,52
만수치안센터,39455,829,592,811,592,18,47
만월종합사회복지관,92065,9,1866,9,1866,0,62
만월중학교,39962,2256,394,2212,394,44,88
만월중학교,39963,122,2552,117,2552,5,89
만의골입구,39666,81,68,80,68,1,4
만의골입구,39672,27,308,27,308,0,11
만정낚시터,35682,69,22,66,22,3,3
만정낚시터,35696,10,34,10,34,0,1
만정낚시터입구,35683,73,68,73,68,0,4
만정낚시터입구,35695,41,48,41,48,0,2
망양돈대,90224,6,38,6,38,0,1
망양돈대,90225,12,8,12,8,0,0
망월3리,43332,217,143,196,143,21,12
망월3리,43580,1,39,0,39,1,1
망월입구,43117,20,0,20,0,0,0
망월입구,43576,81,62,73,62,8,4
망월입구,43790,22,43,21,43,1,2
망월종점,43788,19,17,18,17,1,1
매음1리마을회관,90173,35,37,35,37,0,2
매음1리마을회관,90174,27,7,27,7,0,1
매음3리마을회관(민머루),90321,9,12,9,12,0,0
매음3리마을회관(민머루),90322,27,3,24,3,3,1
매제미고개,43837,2,1,2,1,0,0
매제미고개,43988,0,12,0,12,0,0
먼우금사거리,38114,6514,4004,6484,4004,30,350
먼우금초등학교,38021,2733,10611,2728,10611,5,444
메이루즈커낼파크뷰,42747,3432,9329,3206,9329,226,425
메이루즈커낼파크뷰,42762,10371,3490,10163,3490,208,462
메이루즈커낼파크뷰정문,42794,3783,3651,3720,3651,63,247
메제미,43302,159,21,158,21,1,6
메제미,43598,15,225,15,225,0,8
면사무소입구,90018,3,133,2,133,1,4
면사무소입구,90019,114,10,109,10,5,4
면허시험장,39006,2162,1954,2161,1954,1,137
명가빌라(회차),37553,2304,2201,2155,2201,149,150
명보주택앞,43979,4,8,4,8,0,0
명보주택앞,43984,29,13,27,13,2,1
명신여자고등학교,40289,19263,5359,19052,5359,211,820
명신여자고등학교,40291,6527,12470,6411,12470,116,633
명신초등학교,43394,81,0,75,0,6,2
명신초등학교,43803,4,107,4,107,0,3
명진부페,43632,12,3,12,3,0,0
명현중학교,41405,2680,7651,2672,7651,8,344
명현초등학교,41559,5230,1331,5219,1331,11,218
명현초등학교,41560,1214,3934,1199,3934,15,171
명현초등학교(효성지구대),41069,722,2974,696,2974,26,123
모다아울렛,89190,2558,2573,2539,2573,19,171
모래내시장,39295,15678,13882,15392,13882,286,985
모래내시장,39298,13346,11567,13031,11567,315,830
모래내시장,39344,6592,6008,6592,6008,0,420
모래내시장,39350,10980,12689,10789,12689,191,788
모래내시장역(1번출구),39338,11615,9092,11415,9092,200,690
모래내시장역(2번출구),39909,9731,12551,9573,12551,158,742
모래내시장역(3번출구),39339,34806,32614,34477,32614,329,2247
모래내시장역(4번출구),39335,1969,6104,1950,6104,19,269
모래방죽사거리,89228,1247,1044,1194,1044,53,76
모래방죽사거리,89229,1625,2757,1594,2757,31,146
모름말,90255,3,1,3,1,0,0
모름말,90311,11,5,6,5,5,0
모리부락입구,90304,15,0,15,0,0,0
모아아파트,70033,262,653,258,653,4,30
모아아파트.세종프라자,70034,597,221,580,221,17,27
모현,43659,4,303,4,303,0,10
모현,43689,267,4,261,4,6,9
목감IC진입(미정차),70226,1,0,1,0,0,0
목개마을,90153,10,1,10,1,0,0
목개마을,90154,27,7,22,7,5,1
목너머,35863,60,42,60,42,0,3
목너머,35864,4,36,4,36,0,1
목련어린이집,40824,8500,3789,8384,3789,116,409
목비고개,43032,67,132,58,132,9,6
목비고개,43272,204,72,188,72,16,9
목상교입구,41493,44,3,44,3,0,1
목상교입구,41519,5,24,5,24,0,0
목상교차로,41636,5,220,3,220,2,7
목상교차로,41637,218,5,213,5,5,7
목상동(새봄농원입구),41323,0,72,0,72,0,2
목상동(새봄농원입구),41324,50,3,50,3,0,1
목상동마을입구,41318,0,226,0,226,0,7
목상동마을입구,41517,228,34,221,34,7,8
목상동솔밭.이주단지입구,41316,1647,30,1628,30,19,55
목상동솔밭.이주단지입구,41317,20,1076,11,1076,9,36
목장앞,43503,7,11,6,11,1,0
목장앞,43688,1,2,1,2,0,0
목재단지,42036,423,547,421,547,2,32
목재부두사거리,42949,4,382,4,382,0,12
목재부두사거리,42960,166,39,163,39,3,6
목화빌라,37545,3,328,3,328,0,11
목화예식장,39446,15623,13405,15452,13405,171,967
목화예식장,39448,14470,20772,14331,20772,139,1174
무내미마을,39496,404,811,391,811,13,40
무내미마을,40106,169,3312,150,3312,19,116
무의공영주차장,35871,0,2,0,2,0,0
무의도입구,35001,4610,279,4547,279,63,162
무의도입구,35002,386,5072,380,5072,6,181
무의도주민자치센터,35738,447,32,438,32,9,15
무의도주민자치센터,35739,36,258,36,258,0,9
무지개.한양8차아파트,40271,6706,3752,6655,3752,51,348
무지개.한양8차아파트,40276,5444,8627,5358,8627,86,469
무지개아파트,38366,3384,2619,3321,2619,63,200
무지개아파트(동남아파트),38042,6858,1197,6519,1197,339,268
무학리입구,90276,54,40,54,40,0,3
묵골,43498,15,9,14,9,1,0
묵골,43684,7,14,5,14,2,0
문남마을,38250,8941,4990,8877,4990,64,464
문남초등학교,38214,2656,2325,2604,2325,52,166
문남초등학교,38216,2723,3498,2664,3498,59,207
문말3거리,44084,10,0,5,0,5,0
문말3거리,44169,1,0,1,0,0,0
문말삼거리,44001,453,33,444,33,9,16
문말삼거리,44002,31,445,31,445,0,15
문산교회앞,43340,14,46,10,46,4,2
문산교회앞,43589,35,11,30,11,5,1
문산리마을회관,43101,93,429,87,429,6,17
문일여고·하우스토리만수아파트,39313,1467,4097,1441,4097,26,185
문일여고·하우스토리만수아파트,39314,5500,904,5370,904,130,213
문일여자고등학교후문,39685,2214,3834,2175,3834,39,201
문학경기장(X게임장),37643,128,267,109,267,19,13
문학경기장(박태환수영장),38310,4307,2672,4277,2672,30,232
문학경기장(박태환수영장),38311,1478,4359,1442,4359,36,194
문학경기장(박태환수영장),38329,1516,1479,1465,1479,51,99
문학경기장(박태환수영장),38423,873,1761,868,1761,5,87
문학경기장(야구장),37144,7779,12801,7486,12801,293,686
문학경기장(월드컵경기장),37157,5847,11229,5621,11229,226,569
문학경로당,37087,4918,3241,4834,3241,84,271
문학경로당,37088,4426,3559,4280,3559,146,266
문학고개,37056,3069,2464,3014,2464,55,184
문학고개,37057,2663,3544,2597,3544,66,206
문학고개,37101,2750,3914,2683,3914,67,222
문학우체국,37520,4069,4455,3920,4455,149,284
문학우체국,37521,5490,3245,5386,3245,104,291
문학정보고입구,37107,4315,5836,4222,5836,93,338
문학정보고입구,37108,6318,2497,6138,2497,180,293
문학초등학교,37105,20535,8061,20065,8061,470,953
문학초등학교,37110,8132,15072,7901,15072,231,773
문현,43005,62,81,57,81,5,4
문현,43164,42,51,41,51,1,3
문현,43195,174,37,160,37,14,7
문현,43321,17,154,17,154,0,5
문화교회,40173,333,301,333,301,0,21
문화교회,40174,10057,9741,9852,9741,205,659
문화예술회관,39197,3434,5822,3400,5822,34,308
문화예술회관,39199,894,712,878,712,16,53
물류단지D블럭앞,35604,451,5,448,5,3,15
물류단지F블럭앞,35603,16,475,16,475,0,16
미관광장,38508,4,105,4,105,0,3
미관광장,38512,3,16,3,16,0,0
미단교회사거리,35664,40,55,40,55,0,3
미단교회사거리,35665,9,30,9,30,0,1
미도아파트,37446,1054,1308,1054,1308,0,78
미도아파트,41027,10645,3219,10510,3219,135,462
미도아파트,41028,3857,9976,3786,9976,71,461
미래빌라,36088,6082,815,5928,815,154,229
미래빌라,36089,1413,4398,1386,4398,27,193
미래타운1.2단지,40683,4510,18573,4416,18573,94,769
미래타운1.2단지,40684,13426,2881,13274,2881,152,543
미래타운5단지,40672,1040,4247,1032,4247,8,176
미래타운5단지501동,40662,5783,278,5727,278,56,202
미래타운5단지505동,40669,6697,3173,6533,3173,164,329
미래테크원,92015,2418,875,2403,875,15,109
미루지,43420,16,16,14,16,2,1
미루지,43522,68,14,67,14,1,2
미륭아파트,36138,3573,602,3531,602,42,139
미륭아파트,36139,688,3230,660,3230,28,130
미림극장,36008,1223,6586,1163,6586,60,260
미림극장,36009,8522,2162,8312,2162,210,356
미림극장입구,36141,82,328,77,328,5,13
미산초등학교,40378,6855,9923,6701,9923,154,559
미송초등학교,38654,15566,971,15191,971,375,551
미송초등학교(하행),38653,1824,8178,1716,8178,108,333
미주탕,42123,3541,10952,3469,10952,72,483
미주탕,42124,11044,5585,10772,5585,272,554
미추홀경찰서(장미아파트),37524,862,3810,826,3810,36,155
미추홀공원,38368,7540,2947,7408,2947,132,349
미추홀구청,37304,5168,4087,4948,4087,220,308
미추홀구청,37307,823,2423,814,2423,9,108
미추홀구청입구,37306,9474,17329,9354,17329,120,893
미추홀구청입구,37312,10596,11721,10313,11721,283,743
미추홀구평생학습관,37073,6381,5931,6264,5931,117,410
미추홀도서관·인천신월초등학교,39270,3787,8826,3690,8826,97,420
미추홀아파트,40250,136,543,136,543,0,22
미추홀아파트,40254,235,271,235,271,0,16
미추홀외고,39689,586,934,580,934,6,50
미추홀외고,39690,949,502,919,502,30,48
미추홀퍼스트(2단지),37220,8559,3378,8338,3378,221,397
미추홀퍼스트(2단지),37642,3325,8805,3245,8805,80,404
미추홀퍼스트2단지,37646,2590,417,2555,417,35,100
미추홀퍼스트3단지,37647,667,3020,642,3020,25,122
민머루해수욕장,90336,13,11,11,11,2,0
민방위교육장,38610,71,535,71,535,0,20
민방위교육장,38611,636,301,630,301,6,31
민방위교육장,39733,8122,2592,8034,2592,88,357
민방위교육장,39734,97,2444,79,2444,18,84
민방위교육장입구,41043,1916,5556,1854,5556,62,249
바로크아파트,42530,805,508,791,508,14,43
박공현,43228,43,5,35,5,8,1
박공현,43294,10,53,10,53,0,2
박문여자고등학교,39799,1016,203,982,203,34,40
박문여자고등학교,39800,401,560,399,560,2,32
박문중학교,39844,749,207,749,207,0,31
박문중학교,39847,343,3064,339,3064,4,113
박문중학교정문,39860,3186,247,3159,247,27,114
박문중학교후문,39859,260,64,252,64,8,10
박물관앞,43668,27,205,27,205,0,7
박물관앞,43698,249,57,240,57,9,10
박촌마을입구,35670,136,9,135,9,1,4
박촌마을입구,35671,4,230,4,230,0,7
박촌역,41309,18171,23940,17817,23940,354,1403
박촌역,41310,18365,12026,18246,12026,119,1013
반달마을.법원.검찰청,55014,1546,4276,1519,4276,27,194
반도유보라,42904,526,1502,518,1502,8,67
반도유보라,42905,2507,468,2430,468,77,99
반도유보라,42963,2115,829,2032,829,83,98
반도유보라,42985,3065,1505,3009,1505,56,152
반디모텔,44126,1,0,1,0,0,0
반디모텔,44170,0,1,0,1,0,0
반찬단지,89426,304,221,292,221,12,17
반찬단지,89427,497,77,490,77,7,19
반포역,31034,169,3139,169,3139,0,110
반포역,31035,5093,87,5088,87,5,172
발산초등학교(풍림아이원),42433,303,143,303,143,0,14
발전소삼거리,44115,103,151,99,151,4,8
발전소삼거리,44171,14,0,14,0,0,0
밝게,43990,7,2,7,2,0,0
밝게,43991,1,11,1,11,0,0
밤나무골,43022,93,123,81,123,12,7
밤나무골,43023,168,118,164,118,4,9
방개마을,90141,47,14,45,14,2,2
방개마을,90142,1,15,1,15,0,0
방아머리,62008,352,37,325,37,27,12
방아머리,62032,41,155,41,155,0,6
방아머리선착장,62007,47,449,46,449,1,16
방아머리제1주차장,62031,61,314,61,314,0,12
방아머리제1주차장,62041,529,74,516,74,13,20
방죽골,39763,2361,2960,2287,2960,74,177
방죽골,39764,885,2722,866,2722,19,120
방죽말,43027,70,115,67,115,3,6
방죽말,43214,28,103,24,103,4,4
방죽삼거리,39173,309,1085,307,1085,2,46
방죽삼거리,39174,719,476,701,476,18,39
방죽삼거리,42681,1715,593,1675,593,40,76
방죽삼거리,42683,372,1102,350,1102,22,49
방촌공원,40419,2333,2717,2323,2717,10,168
방축삼거리,36159,602,491,585,491,17,36
방파제입구,35048,14,911,7,911,7,30
방화동도시개발11단지,25026,872,62,847,62,25,31
방화중학교,25008,3964,74,3941,74,23,134
방화중학교,25009,32,1038,32,1038,0,35
배다리,35186,10465,18337,10345,18337,120,960
배다리삼거리,36006,11582,8351,11254,8351,328,664
배다리삼거리,36007,7557,8593,7308,8593,249,538
배다리성냥마을박물관,36167,21,21,21,21,0,1
배다리청과물시장,35184,4199,2908,4096,2908,103,236
배다리헌책방거리,36158,426,501,409,501,17,30
배수지입구,42774,620,18,592,18,28,21
백두아파트,42632,8845,3918,8701,3918,144,425
백련사입구,43419,19,65,18,65,1,2
백련사입구,43808,27,1,27,1,0,0
백련산입구,35773,2,6,2,6,0,0
백련산입구,35778,1,31,0,31,1,1
백마장입구,40389,10519,2988,10441,2988,78,450
백마장입구,40390,2607,9353,2586,9353,21,398
백마장입구,40399,18180,19179,18038,19179,142,1245
백마장입구,40407,9644,9163,9471,9163,173,626
백병원(송림패션몰),36151,330,64,327,64,3,13
백사장회센터,62033,25,145,23,145,2,5
백사장회센터,62039,151,25,149,25,2,5
백산아파트,38112,3777,4634,3595,4634,182,280
백산아파트,38113,3900,4601,3817,4601,83,283
백산아파트,38328,1834,1551,1789,1551,45,112
백석고가(하이마트),42381,4497,3772,4374,3772,123,275
백석고가(하이마트),42578,3843,3838,3749,3838,94,256
백석마을,35096,0,16,0,16,0,0
백석중.고등학교,42374,5404,3595,5215,3595,189,299
백석중.고등학교,42375,3807,6336,3699,6336,108,338
백석중사거리,89238,7,229,7,229,0,7
백석중사거리,89239,49,474,6,474,43,17
백승아파트,41383,109,675,92,675,17,26
백승아파트,41384,108,305,108,305,0,13
백암왕순대앞,38483,2148,1820,2107,1820,41,132
백영아파트,40058,11702,4754,11503,4754,199,548
백영아파트,41361,7717,51,7622,51,95,258
백운곡,43040,199,85,196,85,3,9
백운곡,43295,61,234,59,234,2,9
백운공원,40072,14,794,7,794,7,26
백운공원(부평아트센터),40075,673,4625,671,4625,2,176
백운공원(부평아트센터),40076,3536,1247,3448,1247,88,159
백운역,40079,14765,22261,14659,22261,106,1234
백운역,40080,25314,21421,25199,21421,115,1557
백운역,40081,58389,53048,57928,53048,461,3714
백운역,40716,12701,3039,12572,3039,129,524
백운역(파출소),40094,108,1981,101,1981,7,69
백운역(하행),40901,2545,8948,2514,8948,31,383
백운프라자,37181,4493,10115,4371,10115,122,486
백운프라자,37185,7546,4673,7429,4673,117,407
백조아파트,40386,300,796,299,796,1,36
백조아파트,40388,1452,653,1420,653,32,70
뱃말항,44172,0,2,0,2,0,0
뱅뱅사거리,31012,13,1768,12,1768,1,59
뱅뱅사거리,32001,2283,21,2281,21,2,76
버드러지,43428,17,29,17,29,0,1
버드러지,43476,83,35,79,35,4,3
번영로제1사거리,39113,361,1200,359,1200,2,52
번영로제3사거리,39036,836,274,824,274,12,37
번영로제3사거리,39037,206,970,185,970,21,39
벌말,43175,5,49,4,49,1,1
벌말,43297,72,6,72,6,0,2
벌판마을입구,35763,5,129,3,129,2,4
벌판마을입구,35764,118,79,108,79,10,6
범양상가,42118,4669,11109,4646,11109,23,525
범양상가,42122,10475,2592,10340,2592,135,435
범양아파트,42116,8659,2916,8484,2916,175,385
범양아파트(종점),42127,134,4,127,4,7,4
범허리 종점,43973,1,0,1,0,0,0
범허리종점,43974,52,32,45,32,7,2
법원,37130,305,1884,298,1884,7,72
법원,37131,1990,1196,1971,1196,19,106
법원.검찰청,37074,7839,5870,7713,5870,126,456
법원.검찰청.복사골문화센터.반달마을,55020,4042,2387,4001,2387,41,214
법원검찰청입구,37078,3509,4270,3400,4270,109,259
베어즈베스트골프장,89268,374,1160,369,1160,5,51
베어즈베스트골프장,89269,402,2903,401,2903,1,110
베어즈베스트청라GC,89046,86,154,86,154,0,8
베어즈베스트청라GC,89047,48,296,48,296,0,11
벧엘교회,39740,179,1615,133,1615,46,59
벽산.이삭아파트,39453,20757,25380,20603,25380,154,1537
벽산1차아파트,70023,98,1687,94,1687,4,59
벽산1차아파트,70024,2210,242,2148,242,62,81
벽산아파트,39459,2005,36,1966,36,39,68
벽산아파트,39549,24,3619,17,3619,7,121
벽산아파트(미추홀도서관),39273,12572,4006,12374,4006,198,552
벽산이삭아파트,39458,19991,12820,19792,12820,199,1093
별립산입구,43588,0,116,0,116,0,3
별립산입구,43778,98,1,76,1,22,3
병무청(학익풍림아이원),37013,38,25,33,25,5,2
병무청(학익풍림아이원),37671,47,1114,45,1114,2,38
병방사거리,41301,597,2891,573,2891,24,116
병방사거리,41303,6116,2043,5968,2043,148,271
병방초등학교,41302,640,854,631,854,9,49
병방초등학교,41304,1618,1428,1589,1428,29,101
병방초등학교(계양산전통시장),41299,17378,14588,17148,14588,230,1065
보건소,43626,2,34,2,34,0,1
보건환경연구원,35158,2687,2247,2623,2247,64,164
보라매역.동작세무서,19013,250,10,250,10,0,8
보람프라자앞,42442,28934,16743,28622,16743,312,1522
보릿고개,43517,27,419,25,419,2,14
보릿고개,43880,229,89,212,89,17,10
보무기,90165,9,69,9,69,0,2
보무기,90166,45,35,45,35,0,2
보문사,90206,1777,1296,1695,1296,82,102
보스턴힐,89461,37,437,37,437,0,15
보스턴힐,89462,204,242,202,242,2,14
보트비,89424,36,241,31,241,5,9
보트비,89425,132,52,131,52,1,6
보훈회관,39484,5183,9174,5098,9174,85,478
복사골문화센터.한아름마을,55026,1828,3586,1815,3586,13,180
복지회관,38079,2198,1133,2161,1133,37,111
복지회관,38080,871,3559,832,3559,39,147
본향교회,39164,12826,2731,12598,2731,228,518
볼보트럭남인천사업소,35814,836,961,824,961,12,59
봉골,43535,20,9,19,9,1,0
봉골,43673,10,49,9,49,1,1
봉성(오상2리),43261,0,67,0,67,0,2
봉성(오상2리),43377,93,1,85,1,8,3
봉소리마을회관,43000,67,14,60,14,7,2
봉소리마을회관,90001,16,19,13,19,3,1
봉수초등학교,42980,81,387,79,387,2,15
봉수초등학교,42981,81,956,79,956,2,34
봉수파출소,42982,1248,1767,1226,1767,22,100
부개1동행정복지센터,40191,2771,6505,2731,6505,40,309
부개1동행정복지센터,40193,7548,4800,7385,4800,163,411
부개2동행정복지센터,40323,1735,515,1735,515,0,75
부개2파출소,40317,444,325,435,325,9,25
부개2파출소,40318,3358,4809,3255,4809,103,272
부개2파출소,40329,4170,1741,4072,1741,98,197
부개2파출소,40764,108,257,108,257,0,12
부개3동행정복지센터,40494,1658,286,1631,286,27,64
부개3동행정복지센터입구,40486,189,1510,186,1510,3,56
부개6단지후문.웅진플레이,55021,42,1944,33,1944,9,66
부개고입구,40345,3873,4808,3741,4808,132,289
부개고입구,40783,6539,2815,6382,2815,157,311
부개농협,40199,488,2425,467,2425,21,97
부개농협,40201,2563,1020,2487,1020,76,119
부개사거리,40923,143,945,127,945,16,36
부개서초등학교,40243,1926,743,1926,743,0,88
부개성일아파트,40293,7653,3359,7515,3359,138,367
부개성일아파트,40301,5878,10950,5661,10950,217,560
부개여자고등학교,40421,2947,1445,2923,1445,24,146
부개여자고등학교,40422,2122,2339,2091,2339,31,148
부개여자고등학교,40423,8617,5224,8593,5224,24,461
부개여자고등학교,40428,3728,5852,3696,5852,32,319
부개역,40222,2213,8266,2087,8266,126,349
부개역,40223,7820,3738,7628,3738,192,385
부개역,40256,35402,19379,34636,19379,766,1826
부개우체국,40458,9837,7013,9767,7013,70,561
부개종합시장,40504,9000,3797,8835,3797,165,426
부개주공2단지,40772,484,661,475,661,9,38
부개주공3단지,40479,3113,1206,3097,1206,16,143
부개주공3단지정문,40460,397,797,384,797,13,39
부개주공3단지후문,40500,3668,6244,3642,6244,26,330
부개주공6단지,40442,3990,2282,3940,2282,50,209
부개주공6단지,40459,4092,4286,4087,4286,5,279
부개주공7단지,40385,8187,3574,8172,3574,15,392
부개주공7단지,40387,3684,5720,3669,5720,15,313
부광여자고등학교,40471,449,1570,443,1570,6,67
부광초등학교,40434,1534,4236,1497,4236,37,192
부광초등학교,40440,5499,1904,5388,1904,111,246
부근삼거리,43586,597,83,569,83,28,22
부근삼거리,43652,157,460,139,460,18,20
부근삼거리,90403,0,2,0,2,0,0
부근삼거리,90404,13,2,13,2,0,0
부대아래,90106,6,6,6,6,0,0
부대아래,90107,22,3,20,3,2,0
부대앞,18392,154,3,154,3,0,5
부대앞,18397,1,76,1,76,0,2
부대앞,38594,138,265,138,265,0,13
부대앞,41321,180,537,163,537,17,23
부대앞,41322,301,1129,301,1129,0,47
부대앞,41531,34,147,34,147,0,6
부대앞,41532,92,105,92,105,0,6
부대앞,42342,295,661,289,661,6,31
부대앞,42343,195,267,193,267,2,15
부대앞,43435,28,19,28,19,0,1
부대앞,43787,59,24,59,24,0,2
부동산입구,38278,2876,1323,2859,1323,17,139
부동산입구,38743,211,600,208,600,3,27
부명고.순천향대학병원,55036,2253,6438,2238,6438,15,289
부원여중·동아아파트,40202,5742,2193,5570,2193,172,264
부원여중·동아아파트,40208,1194,5377,1171,5377,23,219
부원중학교,40181,27178,16513,26558,16513,620,1456
부원중학교,40789,11655,29042,11450,29042,205,1356
부일여자중학교,40123,15685,2353,15560,2353,125,601
부천IC,57023,2667,2645,2625,2645,42,177
부천IC,57025,3875,2504,3850,2504,25,212
부천시청역1번출구,55061,2407,739,2404,739,3,104
부천시청역2번출구.현대백화점.이마트,55054,18468,8917,18311,8917,157,912
부천시청역3번출구.경기예고.현대백화점,55057,7526,9444,7524,9444,2,565
부천시청역4번출구.현대백화점.경기예고,55059,9007,6700,8948,6700,59,523
부천시청역5번출구,55060,1212,4523,1211,4523,1,191
부천실내체육관,55075,814,1743,812,1743,2,85
부천오정물류단지(중),57042,447,877,445,877,2,44
부천오정물류단지(중),57043,499,901,496,901,3,46
부천자동차검사소,57017,970,1465,949,1465,21,81
부천자동차검사소,57041,1442,1550,1426,1550,16,99
부천터미널소풍,55051,2271,8408,2257,8408,14,355
부천테크노파크1.2단지,57001,1478,2171,1466,2171,12,121
부천테크노파크1단지,57003,2033,2035,2022,2035,11,135
부평2동행정복지센터,40744,273,1200,261,1200,12,49
부평4동성당,40377,3560,2710,3478,2710,82,209
부평4동성당,40922,1448,2357,1442,2357,6,126
부평6동우체국,40186,1373,502,1340,502,33,62
부평6동행정복지센터,40906,6162,289,5929,289,233,215
부평LH1(2)단지,40160,6779,7831,6702,7831,77,487
부평LH1(2)단지,40161,5065,4754,4936,4754,129,327
부평SKVIEW해모로아파트,40282,688,618,661,618,27,43
부평SKVIEW해모로아파트,40285,745,706,738,706,7,48
부평감리교회,40148,1423,662,1345,662,78,69
부평경찰서,40468,46284,17303,46074,17303,210,2119
부평경찰서,40794,14838,40278,14733,40278,105,1837
부평구보건소,40372,6479,2081,6291,2081,188,285
부평구보건소,40373,2615,7294,2591,7294,24,330
부평구보건소,40858,2520,2367,2485,2367,35,162
부평구보건소,40890,3165,4206,3100,4206,65,245
부평구자활센터,40651,20428,1936,20153,1936,275,745
부평구자활센터,40658,535,11689,519,11689,16,407
부평구청,40462,36111,26168,35905,26168,206,2075
부평구청,40482,6749,4715,6717,4715,32,382
부평구청,40484,4380,5212,4317,5212,63,319
부평구청,40492,4901,17305,4863,17305,38,740
부평구청·부평세무서,40451,29581,38242,29385,38242,196,2260
부평구청역,40841,21289,4700,21220,4700,69,866
부평기적의도서관,40497,6397,3922,6289,3922,108,343
부평기적의도서관.삼부한신아파트,40490,3396,3549,3349,3549,47,231
부평남부역,40169,4005,5356,3944,5356,61,312
부평남부역입구,40170,6768,2873,6662,2873,106,321
부평남초등학교,40141,3584,2434,3484,2434,100,200
부평남초등학교앞,40136,3181,3921,3118,3921,63,236
부평농장,39772,143,1083,142,1083,1,40
부평농장사무소,39483,1439,1920,1412,1920,27,111
부평농장의원입구,39494,299,597,290,597,9,29
부평도서관,40082,1568,3325,1532,3325,36,163
부평도서관,40084,1798,2872,1763,2872,35,155
부평동중,40406,3026,2698,3001,2698,25,190
부평동중,55009,3114,2605,3074,2605,40,190
부평래미안아파트,40437,2414,3568,2348,3568,66,199
부평래미안아파트,40438,5911,2140,5796,2140,115,268
부평북초등학교,40656,1642,573,1578,573,64,73
부평북초등학교,40657,847,3479,820,3479,27,144
부평사거리,40073,2619,6069,2570,6069,49,289
부평사거리,40074,13511,7661,13362,7661,149,705
부평사거리,40887,1617,5713,1484,5713,133,244
부평삼거리,39489,13361,12264,13180,12264,181,854
부평삼거리역,39491,4487,2502,4446,2502,41,232
부평삼거리역,40066,15456,11025,15238,11025,218,882
부평샬레아파트(세일고등학교),40260,1975,7884,1941,7884,34,328
부평샬레아파트(세일고등학교),40263,6070,2408,5962,2408,108,282
부평서중,40092,606,707,606,707,0,43
부평서중,40095,311,788,311,788,0,36
부평시장,40262,58891,29473,58133,29473,758,2945
부평시장,40264,24353,37745,24083,37745,270,2069
부평시장,40265,13443,7561,13190,7561,253,700
부평시장,40283,20062,11940,19850,11940,212,1066
부평시장,40290,11660,9534,11543,9534,117,706
부평시장(가구의거리),40295,32938,29143,32073,29143,865,2069
부평시장(가구의거리),40296,36909,12507,36057,12507,852,1647
부평시장(당약국),40303,1297,1378,1284,1378,13,89
부평시장(용갈비),40344,7326,612,7013,612,313,264
부평시장(한남프라자),40259,16083,10090,15580,10090,503,872
부평시장(한라비발디),40328,6356,2541,6095,2541,261,296
부평시장(한라비발디),40336,10225,17147,10124,17147,101,912
부평시장역,40361,19362,53479,19037,53479,325,2428
부평시장역(부평대로우체국),40368,36633,15547,36216,15547,417,1739
부평시장입구,40288,5216,9408,5125,9408,91,487
부평시장입구(2번출구),40309,9203,10812,9018,10812,185,667
부평아트센터,40078,2362,1462,2326,1462,36,127
부평아트센터,40709,1508,3185,1461,3185,47,156
부평여자고등학교,40365,3733,1445,3647,1445,86,172
부평여자고등학교,40410,7041,7212,6933,7212,108,475
부평여자고등학교,40793,8329,8524,8170,8524,159,561
부평여자중학교,40342,216,471,212,471,4,22
부평여자중학교,40726,295,542,291,542,4,27
부평역,40190,9450,44917,9323,44917,127,1812
부평역,40209,59240,57337,58463,57337,777,3885
부평역,40226,24419,17518,24364,17518,55,1397
부평역,40228,38581,40487,38065,40487,516,2635
부평역,40234,16814,41440,16536,41440,278,1941
부평역,40237,15125,6206,14915,6206,210,711
부평역,40239,9089,9567,8952,9567,137,621
부평역(12번출구),40781,35738,68005,35277,68005,461,3458
부평역(27번출구),40224,37645,7495,37208,7495,437,1504
부평역(CU편의점),40192,37358,3909,36914,3909,444,1375
부평역(대한극장),40196,15382,55312,15294,55312,88,2356
부평역(로터스프라자),40246,19927,27227,19642,27227,285,1571
부평역(북인천우체국),40197,49419,32726,49032,32726,387,2738
부평역사박물관,40597,183,568,177,568,6,25
부평역사박물관,40609,823,222,808,222,15,34
부평역사박물관,40798,452,131,448,131,4,19
부평역화성파크드림아파트,40804,1109,3850,1072,3850,37,165
부평역화성파크드림아파트,40805,4936,1435,4773,1435,163,212
부평우체국,40430,4146,4588,4113,4588,33,291
부평우체국,40432,5367,4483,5292,4483,75,328
부평우체국,40443,342,212,337,212,5,18
부평윤산부인과,40478,518,374,499,374,19,29
부평윤산부인과,40768,543,1856,534,1856,9,79
부평자이,40871,128,988,125,988,3,37
부평정수장,40647,1831,3431,1816,3431,15,175
부평제이타워3차지식산업센터,40644,4251,2927,4239,2927,12,239
부평중앙침례교회,40481,140,1250,133,1250,7,46
부평중학교,40402,3927,4149,3800,4149,127,269
부평중학교,40416,3967,3845,3877,3845,90,260
부평코오롱아파트106동,40404,767,1028,758,1028,9,59
부평코오롱하늘채아파트,40357,609,761,600,761,9,45
부평코오롱하늘채아파트,40360,1301,742,1285,742,16,68
부평테크노타워,40615,2107,1376,2095,1376,12,116
부평테크노타워,40616,2279,3731,2251,3731,28,200
부현동초등학교,41175,11547,4275,11365,4275,182,527
부흥로터리,40412,1803,2229,1778,2229,25,134
부흥오거리(부흥아파트),40392,5648,5617,5541,5617,107,375
부흥오거리(부흥아파트),40394,6943,4140,6895,4140,48,369
부흥오거리(소망병원),40374,5687,9594,5594,9594,93,509
부흥오거리(소망병원),40375,16441,10255,16258,10255,183,889
부흥초교,40302,8132,2379,8051,2379,81,350
부흥초등학교,40299,4515,7702,4463,7702,52,407
부흥초등학교,40304,11146,5854,10998,5854,148,566
부흥초등학교·굿케어요양병원,40878,3825,5671,3770,5671,55,316
북구도서관,40469,3117,2741,3039,2741,78,195
북동삼거리,62001,485,76,479,76,6,18
북동삼거리,62002,88,565,86,565,2,21
북변환승센터.구터미널,80080,637,131,632,131,5,25
북변환승센터.구터미널,80081,1,136,0,136,1,4
북성교회,43744,36,19,31,19,5,1
북성교회,43764,5,6,5,6,0,0
북성마을,43136,179,21,161,21,18,6
북성마을,43528,28,81,27,81,1,3
북인천여자중학교,41007,7799,4951,7691,4951,108,425
북인천여자중학교,41008,5984,6471,5922,6471,62,415
북인천여자중학교,41015,895,14446,883,14446,12,511
북인천여자중학교,41016,8193,363,8061,363,132,285
북항다목적부두,89208,24,1395,19,1395,5,47
북항다목적부두,89209,1184,25,1160,25,24,40
북항배후단지입구,89343,10,618,10,618,0,20
북항배후로입구,89414,3,156,3,156,0,5
북항사업소,89210,16,1125,9,1125,7,38
북항사업소,89211,1202,17,1200,17,2,40
북항입구,89304,250,1250,237,1250,13,50
북항입구,89305,249,152,247,152,2,13
분오리어판장,43406,20,29,19,29,1,1
분오리어판장,43495,1,59,1,59,0,2
분오저수지,43493,1,8,1,8,0,0
분오저수지,43509,47,2,43,2,4,1
불로대곡동행정복지센터,42497,1044,1044,1013,1044,31,69
불로대곡동행정복지센터,42498,1024,2360,1018,2360,6,112
불로중학교,42648,363,1304,355,1304,8,55
불로중학교,42652,481,333,466,333,15,27
불은면주민센터,43035,719,374,678,374,41,36
불은초등학교,43293,105,1,101,1,4,3
불은초등학교,43530,8,31,8,31,0,1
불은파출소,43036,491,656,465,656,26,38
붉은노리삼거리,44112,155,152,146,152,9,10
붉은노리삼거리,44173,10,11,10,11,0,0
뷰티풀파크관리공단,42805,86,8,78,8,8,3
뷰티풀파크관리공단,42806,3,84,1,84,2,2
뷰티풀파크버스공영차고지,42803,49,1402,10,1402,39,48
뷰티풀파크버스공영차고지,42804,2752,31,2632,31,120,92
브라운스톤.엠코타운아파트,40659,11782,15850,11644,15850,138,921
블랙트리캠핑장,44124,22,46,20,46,2,2
블랙트리캠핑장,44174,18,0,18,0,0,0
블루오션골프클럽(앰코코리아),39879,12,576,11,576,1,19
비류마을,38261,1598,1575,1531,1575,67,105
비선삼거리,43114,34,11,29,11,5,1
비선삼거리,43547,554,762,532,762,22,43
비선삼거리,43596,211,88,204,88,7,9
비재고개,35420,187,45,185,45,2,7
비재고개,35421,66,239,66,239,0,10
비젼교회,40171,3645,2446,3564,2446,81,203
빈정공원,42571,1750,931,1730,931,20,89
빈정공원,42670,460,1148,453,1148,7,53
빈정내사거리,42327,1821,2961,1753,2961,68,159
빈정내사거리,42329,682,390,674,390,8,35
사랑마을벽산.선경.삼익아파트,55030,2454,1741,2450,1741,4,139
사리울삼거리,39128,3904,5746,3725,5746,179,321
사리울삼거리,39131,3177,2243,3088,2243,89,180
사리울중학교,39838,1502,4780,1459,4780,43,209
사리울중학교,39924,6855,1460,6612,1460,243,277
사리울초등학교후문,39713,5318,729,5073,729,245,201
사슴농장,43531,78,1,70,1,8,2
사슴농장,43866,0,41,0,41,0,1
사시미재,35731,36,6,36,6,0,1
사시미재,35732,11,33,11,33,0,1
사업.행정지원센터,35607,436,1,435,1,1,14
사업.행정지원센터,35608,24,631,24,631,0,21
사염공원,89037,0,14,0,14,0,0
사염공원,89038,3,0,3,0,0,0
사우고.김포고(걸포사거리방면),80064,5,967,5,967,0,32
사우고.김포시청,80024,180,2793,180,2793,0,99
사우고교.김포시청(직행),80377,1241,115,1240,115,1,45
사우역.김포고(김포초교방면),80380,1160,3523,1159,3523,1,156
사우역.김포고(직행),80043,733,2,729,2,4,24
사우역.김포고(직행),80376,2946,570,2932,570,14,117
사원아파트입구,42777,140,115,104,115,36,8
사일로벽화,35163,43,3915,39,3915,4,131
사일로벽화,35167,1843,276,1815,276,28,70
사조해표,42019,1634,1605,1597,1605,37,107
사조해표,42020,703,1022,683,1022,20,57
사직(해나무),43416,2,78,0,78,2,2
사직(해나무),43797,70,3,68,3,2,2
사촌,43597,74,1,68,1,6,2
사촌,43785,0,9,0,9,0,0
삭은다리한국지엠,40524,143,2654,138,2654,5,93
삭은다리한국지엠,40525,3708,1880,3676,1880,32,186
산곡3동행정복지센터,40156,3521,613,3441,613,80,137
산곡교회,40383,8590,2880,8413,2880,177,382
산곡남초등학교,40227,1709,51,1674,51,35,58
산곡동입구(롯데마트),40779,321,1447,298,1447,23,58
산곡동입구(롯데마트),40785,12513,21515,12318,21515,195,1134
산곡동주안빌딩,40313,13208,2032,13116,2032,92,508
산곡동천주교회,40473,22781,13119,22513,13119,268,1196
산곡동천주교회,40476,9528,21065,9304,21065,224,1019
산곡여자중학교,40198,7409,8076,7251,8076,158,516
산곡여자중학교,40203,2776,4059,2740,4059,36,227
산곡여자중학교,40215,57,1891,50,1891,7,64
산곡여자중학교,40216,5552,110,5447,110,105,188
산곡여자중학교(마장로삼거리),40911,1294,1424,1187,1424,107,90
산곡역(1번출구),40420,5148,19319,5089,19319,59,815
산곡역(3번출구),40856,8658,5493,8564,5493,94,471
산곡역(6번출구),40429,8323,16721,8238,16721,85,834
산곡역(7번출구),40425,38660,29405,38528,29405,132,2268
산곡중학교,40320,401,151,396,151,5,18
산곡중학교,40322,159,1603,156,1603,3,58
산곡한양7차,40354,128,9043,121,9043,7,305
산뒤,43235,27,120,22,120,5,4
산뒤,43887,130,15,124,15,6,4
산림조합앞,90234,31,39,22,39,9,2
산림조합앞,90235,18,90,17,90,1,3
산마루집,41497,33,47,33,47,0,2
산마루집,41513,25,0,25,0,0,0
산마을고등학교,43116,0,7,0,7,0,0
산마을고등학교,43599,1,3,1,3,0,0
산문입구,43107,168,185,166,185,2,11
산문입구,43286,239,247,236,247,3,16
산문입구,43899,18,3,18,3,0,0
산문종점,43154,34,75,34,75,0,3
산애들애,43143,3,8,2,8,1,0
산애들애,43492,6,1,3,1,3,0
산업단지사거리,36095,66,4006,66,4006,0,135
산업단지사거리,37460,7034,461,6965,461,69,249
산업용품센타,42524,6003,407,5992,407,11,213
산업용품센타,42525,65,2781,46,2781,19,94
산업용품유통센타23동,36096,266,1724,266,1724,0,66
산업용품유통센타31동,36097,88,1652,88,1652,0,58
산업용품유통센타39동,36099,233,1766,210,1766,23,66
산업용품유통센터,36156,721,11,705,11,16,24
산업용품유통센터1동,36146,1915,253,1906,253,9,72
산업용품유통센터39동,36157,123,0,119,0,4,4
산업용품유통센터C동,36101,1693,47,1693,47,0,58
산우리고개,43337,0,7,0,7,0,0
산우리고개,43850,11,11,10,11,1,0
산음입구,80004,14,431,13,431,1,14
산음입구,80005,111,18,86,18,25,4
산촌마을,43217,0,1,0,1,0,0
산촌마을,43308,26,18,25,18,1,1
산호아파트앞,80059,1443,221,1443,221,0,55
산화고개,43271,147,13,141,13,6,5
산화고개,43388,18,175,10,175,8,6
삼덕아파트,37403,704,808,704,808,0,50
삼덕아파트,37404,546,1065,546,1065,0,53
삼동암리마을회관,43169,0,22,0,22,0,0
삼동암리마을회관,43227,27,1,27,1,0,0
삼두2차아파트,36051,4575,834,4469,834,106,180
삼라마이다스아파트,89317,145,6,144,6,1,5
삼라마이다스아파트,89323,4,71,3,71,1,2
삼목사거리,35088,9,23,9,23,0,1
삼목선착장,35311,262,1385,262,1385,0,54
삼목선착장(운서역행),35077,2699,654,2674,654,25,111
삼목선착장입구,35058,1,44,1,44,0,1
삼목선착장입구,35059,2,4,2,4,0,0
삼목초등학교,35310,1187,1343,1172,1343,15,84
삼목초등학교,35341,2833,1202,2664,1202,169,134
삼미시장,70172,792,2840,737,2840,55,121
삼미시장,70173,2881,667,2859,667,22,118
삼미타운.e편한세상아파트,40172,5609,5922,5510,5922,99,384
삼보새마을금고,40796,6964,673,6895,673,69,254
삼보아파트,40298,2828,135,2813,135,15,98
삼보아파트,40308,12248,4745,12121,4745,127,566
삼보아파트,40677,7832,402,7756,402,76,274
삼보아파트,40679,517,7007,489,7007,28,250
삼보아파트,40786,4293,17189,4193,17189,100,716
삼보아파트,42350,2774,5722,2741,5722,33,283
삼보아파트,42351,6403,2083,6255,2083,148,282
삼보아파트(계양구청),41205,3854,8792,3789,8792,65,421
삼산건강공원(미정차),40888,1,0,1,0,0,0
삼산경찰서,40584,1160,2970,1141,2970,19,137
삼산경찰서,40766,1990,2987,1962,2987,28,165
삼산고등학교(미래타운3단지),40689,11286,3145,11205,3145,81,481
삼산고등학교(미래타운4단지),40686,5659,8828,5579,8828,80,482
삼산군립어린이집,90171,14,21,13,21,1,1
삼산군립어린이집,90172,10,12,10,12,0,0
삼산글로리병원,40527,7660,7252,7599,7252,61,497
삼산농산물시장,40687,2477,5102,2401,5102,76,252
삼산동차고지,40830,282,11,162,11,120,9
삼산면사무소,90149,18,53,18,53,0,2
삼산면사무소,90150,90,58,84,58,6,4
삼산사거리,40638,5781,10073,5715,10073,66,528
삼산사거리,40690,2950,779,2931,779,19,124
삼산사거리,40691,4867,4258,4808,4258,59,304
삼산사거리(한국아파트),40646,4240,13708,4186,13708,54,598
삼산사거리.한국아파트,40645,5917,1751,5824,1751,93,255
삼산새마을금고,40668,624,7246,616,7246,8,262
삼산서해그랑블,40589,1598,1833,1573,1833,25,114
삼산서해아파트,40613,3042,659,3000,659,42,123
삼산월드체육관,40532,8038,2881,7981,2881,57,363
삼산월드체육관,40535,1317,1266,1291,1266,26,86
삼산월드체육관,40543,70,4594,70,4594,0,155
삼산월드체육관,40571,2347,2678,2292,2678,55,167
삼산월드체육관(삼산주공6단지),40802,1013,2664,990,2664,23,122
삼산저수지앞,90245,12,7,12,7,0,0
삼산저수지앞,90246,0,2,0,2,0,0
삼산주공1단지,40780,2040,28,2007,28,33,68
삼산주공1단지(상가앞),40908,7452,598,7352,598,100,268
삼산주공4단지,40591,835,1773,813,1773,22,86
삼산주공7단지,40547,7700,7149,7548,7149,152,494
삼산주공7단지,40801,6528,8734,6443,8734,85,508
삼산중학교,40636,1426,788,1387,788,39,73
삼산중학교,40637,1096,1124,1057,1124,39,74
삼산체육관역(호수공원),40536,10191,3250,10114,3250,77,448
삼산체육관역(호수공원),40539,488,5624,461,5624,27,203
삼산체육관역.상동호수공원,55040,454,3378,436,3378,18,127
삼산체육관역.상동호수공원,55041,385,794,379,794,6,39
삼산체육관역.영상문화단지정문,55044,10129,3563,10100,3563,29,456
삼산타운1단지,40588,5308,7481,5273,7481,35,426
삼산타운1단지정문,40585,3238,1177,3193,1177,45,147
삼산타운1단지후문,40611,1225,671,1215,671,10,63
삼산타운1단지후문,40612,516,844,508,844,8,45
삼산타운4단지,40608,2897,791,2872,791,25,122
삼산타운6단지,40580,2371,2429,2348,2429,23,160
삼산타운7단지,40576,2755,2821,2745,2821,10,185
삼산푸른솔마을,40653,34,2413,26,2413,8,81
삼선1리마을회관,90263,0,10,0,10,0,0
삼선1리마을회관,90280,8,0,8,0,0,0
삼선1리삼거리,90262,0,11,0,11,0,0
삼선1리삼거리,90281,4,0,4,0,0,0
삼선2리마을회관,90265,3,23,3,23,0,0
삼선2리마을회관,90278,21,2,21,2,0,0
삼선2리입구,90264,0,8,0,8,0,0
삼선2리입구,90279,3,0,3,0,0,0
삼성바이오로직스,39863,48,1616,41,1616,7,55
삼성바이오로직스,39864,4773,105,4763,105,10,162
삼성바이오로직스,39920,3454,2040,3406,2040,48,183
삼성빌라(종점),37572,428,1075,388,1075,40,50
삼성아파트,35140,3206,5793,3161,5793,45,299
삼성아파트,38077,5618,5735,5556,5735,62,378
삼성아파트.남인천농협,38125,5654,7706,5540,7706,114,445
삼양감속기,39085,3,8,3,8,0,0
삼양베이커,35131,16,216,16,216,0,7
삼양베이커,35571,76,30,71,30,5,3
삼양사인천1공장,42027,952,1534,906,1534,46,82
삼양사인천1공장,42031,2953,3900,2937,3900,16,228
삼영물류,42068,7536,1153,7442,1153,94,289
삼영아파트,37116,4796,1311,4659,1311,137,203
삼영아파트,37279,11713,12886,11542,12886,171,819
삼영아파트,37280,9397,5597,9253,5597,144,499
삼영아파트,42085,12883,6695,12533,6695,350,652
삼영테크,89055,1807,219,1786,219,21,67
삼영테크,89062,14,2694,5,2694,9,90
삼원페트라,39041,550,3849,550,3849,0,146
삼은교회,37111,4917,1858,4815,1858,102,225
삼익.광명아파트,39247,10365,13268,10265,13268,100,787
삼익.광명아파트,39249,17186,8201,17072,8201,114,846
삼익아파트,35136,3194,6413,3071,6413,123,320
삼익아파트.달동네박물관,36017,11347,13138,11106,13138,241,816
삼일산업,39097,2290,1647,2276,1647,14,131
삼정동중소기업협동화단지,57015,960,1253,947,1253,13,73
삼정동중소기업협동화단지,57040,1043,813,1025,813,18,61
삼정사거리,57011,690,1060,680,1060,10,58
삼정사거리,57012,856,503,842,503,14,45
삼정초등학교,57008,1159,952,1129,952,30,70
삼정초등학교,57009,571,909,562,909,9,49
삼정프라자,42443,18356,26267,18051,26267,305,1487
삼진금속,39040,2912,383,2903,383,9,109
삼천리1차아파트,41178,3041,2633,2970,2633,71,189
삼천리1차아파트,41179,3032,2309,2940,2309,92,178
삼천리3차아파트,41150,5993,4522,5860,4522,133,350
삼천리3차아파트,41159,5009,5592,4914,5592,95,353
삼천리기계,92017,97,347,94,347,3,14
삼천리기계,92018,141,158,141,158,0,9
삼호제강2공장,39939,130,789,129,789,1,30
삼호제강2공장,39940,546,120,539,120,7,22
삼환1단지아파트,37252,1550,2614,1517,2614,33,138
삼환아파트,38063,1894,3254,1860,3254,34,171
삼환아파트,39296,242,1395,233,1395,9,54
삼환아파트,39299,3550,2368,3510,2368,40,197
삼환아파트,39316,12930,8621,12878,8621,52,718
삼환아파트,39323,947,3866,921,3866,26,160
삼환아파트,39328,8101,7999,8088,7999,13,536
삼환아파트,80058,21,2005,21,2005,0,67
상1리마을회관(창말),90339,3,28,3,28,0,1
상1리마을회관(창말),90342,20,0,20,0,0,0
상1주민지원센터,55074,2355,1774,2295,1774,60,137
상2리마을회관,90337,4,7,4,7,0,0
상2리마을회관,90343,37,0,37,0,0,1
상덕현삼거리,43462,4,6,4,6,0,0
상덕현삼거리,43767,2,5,1,5,1,0
상도중학교,55025,1911,115,1879,115,32,67
상도중학교,55028,547,1914,544,1914,3,82
상동가구,55090,1826,1289,1731,1289,95,103
상동역1번출구.부천터미널소풍.홈플러스,55052,6806,21088,6739,21088,67,929
상동역4번출구.상동지하차도,55048,1625,5926,1581,5926,44,251
상동역5번출구.상동지하차도,55050,15157,3525,15005,3525,152,622
상동역8번출구세이브존,55056,10998,5852,10897,5852,101,561
상사마을,25027,66,224,54,224,12,9
상수도사업본부(스마트타운),37375,5917,8714,5779,8714,138,487
상수도사업본부(스마트타운),37380,4870,11995,4787,11995,83,562
상야동,41436,1381,1134,1364,1134,17,83
상야동,41437,1116,1602,1107,1602,9,90
상용리마을회관,90038,0,51,0,51,0,1
상용리마을회관,90039,48,0,47,0,1,1
상용진료소앞,90004,3,82,1,82,2,2
상용진료소앞,90005,57,7,55,7,2,2
상인천중학교,39537,275,141,271,141,4,13
상인천초등학교,39340,924,502,903,502,21,47
상인천초등학교,39345,398,1136,391,1136,7,51
상정고,40069,13707,3636,13508,3636,199,578
상정고,40070,4975,14194,4962,14194,13,638
상정중학교,40059,5692,7705,5554,7705,138,446
상주(상리),90331,34,9,33,9,1,1
상주민지원센터.삼광교회,55029,1388,4184,1358,4184,30,185
상주민지원센터.삼광교회,55031,5814,547,5736,547,78,212
상촌,43152,32,9,31,9,1,1
상촌,43347,43,61,37,61,6,3
새꾸지마을,90133,20,17,18,17,2,1
새꾸지마을,90134,22,30,22,30,0,1
새마을,43471,3,9,3,9,0,0
새마을,43702,8,5,8,5,0,0
새마을금고,36053,2568,1272,2520,1272,48,128
새마을금고,40125,1099,1177,1088,1177,11,75
새마을금고,40126,2194,287,2089,287,105,82
새마을금고,40131,983,3826,945,3826,38,160
새마을금고,40746,95,969,81,969,14,35
새말사거리,41009,5804,2736,5744,2736,60,284
새말사거리,41010,109,3258,107,3258,2,112
새말사거리,41012,1233,3639,1192,3639,41,162
새말사거리,41013,3725,2488,3688,2488,37,207
새말사거리,41638,875,1946,845,1946,30,94
새별공원,89468,16,1,15,1,1,0
새봄초등학교,38679,2334,3745,2284,3745,50,202
새봄초등학교·송도파크레인(후문),38678,4641,1755,4562,1755,79,213
새사미아파트,41582,544,389,544,389,0,31
새소망교회,40850,1931,12,1879,12,52,64
새소망교회,40917,4,308,2,308,2,10
새안의원,37255,9840,10712,9597,10712,243,685
새안의원,37256,14771,6706,14599,6706,172,715
새한아파트,37046,5007,2493,4896,2493,111,250
색동원 앞,43161,9,12,6,12,3,0
색동원 앞,43215,5,4,5,4,0,0
샘말,43444,8,25,6,25,2,1
샘말,43782,48,9,45,9,3,1
샛말,43994,27,11,27,11,0,1
샛말,43995,13,18,13,18,0,1
생산기술연구원,38354,335,828,331,828,4,38
생설미,43746,429,272,402,272,27,23
생설미입구,43125,13,13,13,13,0,0
생설미입구,43607,8,3,8,3,0,0
생설미입구,43608,1,59,1,59,0,2
샬롬원입구,90293,6,5,6,5,0,0
샬롬원입구,90297,1,0,1,0,0,0
서곶지구대,42338,12368,8097,12096,8097,272,682
서곶지구대,42339,11748,9765,11539,9765,209,717
서교동,23037,176,4308,176,4308,0,149
서교동,23038,10843,290,10828,290,15,371
서구국민체육센터,42776,794,3886,782,3886,12,156
서구문화회관,42212,1568,2242,1538,2242,30,127
서구문화회관,42213,3289,1003,3243,1003,46,143
서구보건소,42283,4837,3988,4724,3988,113,294
서구보건소,42285,3905,5047,3795,5047,110,298
서구영어마을,42448,6167,3864,6084,3864,83,334
서구영어마을,42449,4308,8870,4150,8870,158,439
서구청역(1번출구),42289,4168,4148,4115,4148,53,277
서구청역(3번출구),42284,1231,763,1213,763,18,66
서구청역(4번출구),42296,2324,2566,2267,2566,57,163
서남촌,43151,11,5,11,5,0,0
서남촌,43640,5,12,5,12,0,0
서당골,35676,20,38,20,38,0,1
서당골,35702,16,21,16,21,0,1
서두머리,43212,42,0,40,0,2,1
서두머리,43336,0,10,0,10,0,0
서림초등학교,36036,12,783,10,783,2,26
서림초등학교,36047,13604,1256,13571,1256,33,495
서릿목,35418,136,556,136,556,0,23
서릿목,35419,502,107,496,107,6,20
서면초등학교,38384,2029,1460,1998,1460,31,116
서문안,43385,26,139,26,139,0,5
서문안,43584,236,22,209,22,27,8
서문안주유소,43965,118,28,117,28,1,4
서문안주유소,43966,61,208,58,208,3,8
서부경찰서,42286,577,791,574,791,3,45
서부공단입구,42299,3578,4184,3559,4184,19,258
서부공단입구,42301,5528,1276,5499,1276,29,226
서부산업단지,89035,45,51,45,51,0,3
서부산업단지,89036,40,319,40,319,0,11
서사체험학습장,43487,22,14,21,14,1,1
서사체험학습장,43712,7,14,7,14,0,0
서성,43234,34,182,31,182,3,7
서성,43362,257,30,242,30,15,9
서운교,41114,750,5025,718,5025,32,192
서운교,41115,4401,346,4322,346,79,158
서운도서관,41099,1686,268,1680,268,6,65
서운도서관,41102,214,1981,202,1981,12,73
서운동,41356,8508,3292,8278,3292,230,393
서운동성당,41207,1523,2367,1393,2367,130,129
서운일반산업단지,41660,690,1,686,1,4,23
서운일반산업단지(맞은편),41661,100,4,95,4,5,3
서운일반산업단지입구,41646,610,3409,608,3409,2,133
서운일반산업단지입구(맞은편),41647,1271,865,1261,865,10,71
서운중고등학교,41109,330,824,320,824,10,38
서운중고등학교,41111,746,566,742,566,4,43
서울경금속,39039,227,2836,226,2836,1,102
서울방화초등학교,25028,52,17,49,17,3,2
서울역,11013,19916,12361,19806,12361,110,1075
서원아파트,37095,1578,1168,1531,1168,47,91
서인천가구단지,42017,833,3028,827,3028,6,128
서인천가구단지,42028,3393,2942,3309,2942,84,211
서인천가구단지,42800,543,80,535,80,8,20
서인천고등학교,42346,4475,5036,4389,5036,86,317
서인천농협,42275,1365,560,1336,560,29,64
서인천농협,42277,221,796,221,796,0,33
서인천세무서,89044,290,72,253,72,37,12
서인천세무서(중),89275,1517,1892,1507,1892,10,113
서인천세무서(중),89276,922,1678,919,1678,3,86
서인천자동차검사소,42640,1044,3178,1033,3178,11,140
서인천자동차검사소,42641,4996,1695,4913,1695,83,223
서창119안전센터,39900,10226,2978,10105,2978,121,440
서창119안전센터,39899,4710,9738,4673,9738,37,481
서창공영차고지,39871,8544,166,8238,166,306,290
서창공영차고지,39872,2799,5847,2178,5847,621,288
서창도서관,39893,1403,1824,1367,1824,36,107
서창도서관,39894,1709,1422,1704,1422,5,104
서창도서관입구,39956,168,1887,160,1887,8,68
서창도서관입구,39957,2900,833,2853,833,47,124
서창동화원,39619,137,828,137,828,0,32
서창동화원,39620,512,399,512,399,0,30
서창베라체아파트후문,39895,335,124,331,124,4,15
서창베라체아파트후문,39896,47,489,47,489,0,17
서창센트라스아파트후문,39916,6357,678,6350,678,7,234
서창센트라스아파트후문,39917,1009,3815,1002,3815,7,160
서창센트럴푸르지오,39811,3872,292,3830,292,42,138
서창센트럴푸르지오,39812,340,3017,316,3017,24,111
서창센트럴푸르지오,39903,14375,7268,14154,7268,221,721
서창센트럴푸르지오,39904,12751,13362,12656,13362,95,870
서창이편한세상1002동,39905,12171,7667,11942,7667,229,661
서창이편한세상1002동,39906,7634,12926,7593,12926,41,685
서창이편한세상정문,39854,677,13130,637,13130,40,460
서창이편한세상정문,39855,13611,556,13282,556,329,472
서창퍼스트뷰후문,39777,11032,2941,10975,2941,57,465
서창퍼스트뷰후문맞은편,39778,1495,9671,1487,9671,8,372
서창휴먼시아12단지,39897,2785,192,2755,192,30,99
서창휴먼시아12단지,39898,305,2148,286,2148,19,81
서초구청,22129,295,40,295,40,0,11
서초동삼성아파트,22140,35,209,35,209,0,8
서초아트자이아파트,31050,4658,11926,4647,11926,11,552
서초역1번출구,31007,11435,29676,11424,29676,11,1370
서초힐스아파트,22286,769,1672,767,1672,2,81
서한리구마을회관,90294,20,28,20,28,0,1
서한리구마을회관,90296,13,1,13,1,0,0
서한리마을회관,90295,33,23,33,23,0,1
서한리입구,90292,1,1,1,1,0,0
서해5도특별경비단,35098,1480,64,1441,64,39,51
서해그랑블,39621,1196,362,1196,362,0,51
서해그랑블,40828,1976,331,1976,331,0,76
서해그랑블,42789,3301,8920,3216,8920,85,407
서해그랑블,42790,6702,2778,6511,2778,191,316
서해그랑블,42912,4318,739,4220,739,98,168
서해그랑블1단지아파트,38604,943,21,940,21,3,32
서해그랑블1단지아파트,38605,71,705,69,705,2,25
서해그랑블3단지아파트,38725,309,30,297,30,12,11
서해그랑블3단지아파트,38726,19,452,18,452,1,15
서해그랑블아파트후문,39973,2038,2109,1999,2109,39,138
서해그랑블아파트후문,39974,2682,3158,2674,3158,8,194
서해그랑블후문,40610,63,916,62,916,1,32
서해수산연구소,35007,128,9,120,9,8,4
서해수산연구소,35008,13,275,13,275,0,9
서해아파트,38164,2345,696,2320,696,25,101
서해아파트,38169,826,1912,809,1912,17,91
서해아파트,41181,1708,2230,1629,2230,79,131
서해아파트,41182,3159,1536,3106,1536,53,156
서해아파트,42354,3438,9143,3349,9143,89,419
서해아파트,42355,14114,3855,13820,3855,294,598
서홍의입구,43446,1,10,1,10,0,0
서홍의입구,43796,36,8,36,8,0,1
서화초등학교(도화e편한세상),37438,12948,7259,12774,7259,174,673
서화초등학교(도화e편한세상),37623,10023,10001,9928,10001,95,667
서흥초등학교,36071,7615,3389,7452,3389,163,366
서흥초등학교,36116,771,331,745,331,26,36
서흥초등학교,36117,235,2397,231,2397,4,87
석건연립,37051,1802,6678,1776,6678,26,282
석남고가교입구사거리,42655,22720,8929,22541,8929,179,1054
석남고가사거리,42145,19324,15818,18968,15818,356,1171
석남고가사거리,42151,20682,14863,20430,14863,252,1184
석남금호어울림아파트101동,42656,4434,8758,4376,8758,58,439
석남도서관,42182,886,2219,875,2219,11,103
석남동차고지,89156,1169,12,1037,12,132,39
석남서초등학교,42108,4798,3111,4764,3111,34,263
석남신사거리,42149,2363,1855,2294,1855,69,140
석남신사거리,42150,2537,2803,2476,2803,61,178
석남역(5번출구),42577,20992,38663,20740,38663,252,1988
석남중앙교회,42138,2729,1908,2656,1908,73,154
석남중학교,42126,8226,5982,8057,5982,169,473
석남중학교,42128,6967,7606,6793,7606,174,485
석남초등학교,42165,11058,3379,10797,3379,261,481
석남초등학교,42167,3359,9144,3294,9144,65,416
석락아파트,37241,11893,9417,11662,9417,231,710
석락아파트,37244,2580,4031,2541,4031,39,220
석모1리마을회관,90145,45,15,45,15,0,2
석모1리마을회관,90146,2,16,2,16,0,0
석모대교(석모리방향),90137,14,30,14,30,0,1
석모대교(석모리방향),90138,23,15,23,15,0,1
석모대교(석포리방향),90139,15,1,15,1,0,0
석모대교(석포리방향),90140,28,62,24,62,4,3
석모대교(외포리방향),90121,6,33,5,33,1,1
석모대교(외포리방향),90122,17,13,17,13,0,1
석모대교전망대,90249,7,19,7,19,0,0
석모대교전망대,90250,22,12,22,12,0,1
석모도미네랄온천,90163,51,41,48,41,3,3
석모도미네랄온천,90164,13,56,13,56,0,2
석모도수목원입구(삼산초등학교),90143,13,49,10,49,3,2
석모도수목원입구(삼산초등학교),90144,99,35,98,35,1,4
석모도자연휴양림입구,90151,0,21,0,21,0,0
석모도자연휴양림입구,90152,15,28,15,28,0,1
석바위,37365,25896,19682,25525,19682,371,1519
석바위,37370,55665,44101,54955,44101,710,3325
석바위시장,37378,2753,6824,2652,6824,101,319
석바위시장,37381,26093,25652,25802,25652,291,1724
석바위시장,37382,22856,21104,22607,21104,249,1465
석바위시장,37384,5159,4090,5025,4090,134,308
석바위시장,37544,3115,5130,3063,5130,52,274
석바위시장역,37373,4718,4920,4608,4920,110,321
석바위시장역,37374,3852,4310,3779,4310,73,272
석산,43375,11,67,11,67,0,2
석산,43833,44,15,43,15,1,1
석산로,92051,1007,456,955,456,52,48
석산로,92052,423,631,411,631,12,35
석암초등학교,37412,4188,4220,4078,4220,110,280
석암초등학교앞,37407,14588,8324,14320,8324,268,763
석정여자고등학교,39416,1657,272,1616,272,41,64
석정여자고등학교,39418,100,1875,96,1875,4,65
석조여래입상앞,43663,0,44,0,44,0,1
석조여래입상앞,43692,66,4,64,4,2,2
석천사거리,39308,723,751,717,751,6,49
석천사거리역,39317,4301,7637,4232,7637,69,397
석천사거리역,39320,2792,3141,2727,3141,65,197
석천시장,39502,749,4384,734,4384,15,171
석포리마을회관,90191,13,9,13,9,0,0
석포리마을회관,90192,6,19,6,19,0,0
석포항,90203,70,70,65,70,5,4
선경그린빌라,42307,2268,1898,2220,1898,48,138
선경그린빌라,42541,38,778,38,778,0,27
선경아파트,40238,7685,1915,7685,1915,0,320
선광,38542,16,355,16,355,0,12
선광,38543,225,24,223,24,2,8
선녀바위유원지,35004,956,28,945,28,11,32
선녀바위유원지,35006,165,873,165,873,0,34
선녀바위해수욕장,35484,1658,191,1658,191,0,61
선녀바위해수욕장,35485,75,1632,75,1632,0,56
선동,43248,3,10,0,10,3,0
선동,43886,35,2,34,2,1,1
선두1리,43009,320,80,319,80,1,13
선두1리,43099,66,311,63,311,3,12
선두4리마을회관,43242,19,2,19,2,0,0
선두4리마을회관,43644,3,12,3,12,0,0
선두5리어판장입구,90131,7,7,7,7,0,0
선두5리어판장입구,90132,20,5,20,5,0,0
선릉역,23218,1586,6,1586,6,0,53
선릉역,23259,13,2638,13,2638,0,88
선린감리교회,40043,3376,2107,3331,2107,45,182
선린감리교회,40047,4191,5828,4132,5828,59,333
선바위역,66001,24761,866,24736,866,25,854
선바위역,66002,1344,41183,1344,41183,0,1417
선수,43433,2,11,2,11,0,0
선수,43483,12,5,8,5,4,0
선수여객선착장,43429,379,220,351,220,28,19
선수여객선착장,43479,3,88,3,88,0,3
선수촌사거리,39889,225,659,198,659,27,29
선수촌사거리,39890,462,387,448,387,14,28
선원면사무소앞,90067,0,17,0,17,0,0
선원면사무소앞,90068,11,19,10,19,1,1
선원면주민센터,43042,280,402,270,402,10,22
선원면주민센터,43070,382,227,364,227,18,20
선원사,43305,0,4,0,4,0,0
선원사,43742,22,10,18,10,4,1
선원사초입,43307,10,9,8,9,2,0
선원사초입,43756,9,19,7,19,2,0
선원초등학교,43044,47,160,47,160,0,6
선원초등학교,43045,178,52,174,52,4,7
선유고등학교,28017,13188,727,13170,727,18,463
선유고등학교,28018,705,13269,704,13269,1,465
선재대교,44085,6,1,5,1,1,0
선재대교,44175,3,6,3,6,0,0
선재대교입구,44005,28,716,28,716,0,24
선재대교입구,44006,809,33,795,33,14,28
선재바다낚시터,44146,1,0,1,0,0,0
선주삼거리,41481,25,102,24,102,1,4
선주삼거리,41502,7,2,7,2,0,0
선주지교회,41482,35,90,33,90,2,4
선주지교회,41503,17,1,17,1,0,0
선주지다리,41480,0,33,0,33,0,1
선주지다리,41501,1,2,1,2,0,0
선주지회차지,41483,54,93,52,93,2,4
선학동행정복지센터.정광아파트,38297,1388,910,1380,910,8,76
선학사거리,38295,1366,4009,1288,4009,78,179
선학아파트,38232,6721,1237,6685,1237,36,265
선학아파트,38343,3032,10334,2976,10334,56,445
선학어린이집,38300,1748,1985,1714,1985,34,124
선학역,38305,34386,17377,34164,17377,222,1725
선학역(1번출구),38306,21457,26041,21343,26041,114,1583
선학중학교,38283,893,921,865,921,28,60
선학체육관(하키경기장),38308,1759,1356,1740,1356,19,103
선학체육관(하키경기장),38309,1620,3210,1574,3210,46,161
선행리입구,43908,13,65,11,65,2,2
선행리입구,43909,44,4,43,4,1,1
설호아파트,43378,27,63,27,63,0,3
설호아파트,43618,98,74,94,74,4,5
성강지식산업센터,39837,685,811,682,811,3,49
성경,43603,137,13,134,13,3,5
성경,43771,26,192,25,192,1,7
성리중학교,39969,49,10,49,10,0,1
성리중학교,39979,0,166,0,166,0,5
성리초등학교,39200,21774,20550,21477,20550,297,1410
성리초등학교,39201,9860,16365,9764,16365,96,874
성문교회,39462,591,7,585,7,6,19
성문아파트,39591,4355,1745,4309,1745,46,203
성문아파트(문화연립),39257,3194,4254,3110,4254,84,248
성민병원,42159,16668,15587,16118,15587,550,1075
성민병원,42162,15170,17195,14820,17195,350,1078
성보공업,42007,1997,2218,1943,2218,54,140
성산교회,40572,1304,7504,1261,7504,43,293
성신아크릴산업,89313,166,3,151,3,15,5
성신아크릴산업,89327,0,151,0,151,0,5
성웅아파트,42048,3767,2602,3687,2602,80,212
성웅아파트,42051,4226,2766,4185,2766,41,233
성원기계,92016,1093,1477,1093,1477,0,85
성원빌딩.우편취급국,37425,12079,6268,11970,6268,109,611
성원아파트,70022,2025,16,1997,16,28,68
성일산업,39787,923,1408,919,1408,4,77
성일산업,39788,1197,775,1191,775,6,65
성일아파트후문앞,40311,757,378,752,378,5,37
성지아파트,38017,22378,38399,22262,38399,116,2025
성지아파트,41025,5772,3177,5684,3177,88,298
성지초등학교,41033,1992,3941,1927,3941,65,197
성지초등학교,41034,2923,1750,2873,1750,50,155
성터지,43038,264,94,261,94,3,11
성터지,43039,55,249,55,249,0,10
성호공원,38748,2948,4738,2843,4738,105,256
성호아파트,38204,7823,6008,7600,6008,223,461
세광2차아파트,43758,1695,553,1620,553,75,74
세광2차아파트,43857,320,1224,312,1224,8,51
세광아파트,43049,1035,1891,998,1891,37,97
세광아파트,43050,2322,639,2261,639,61,98
세농푸드,41510,45,0,44,0,1,1
세우산업,39094,1553,4263,1548,4263,5,193
세월천사거리,40489,4682,9602,4639,9602,43,476
세일빌라.인천산림조합,39158,2234,1177,2198,1177,36,113
세일빌라.인천산림조합,39159,4910,3721,4900,3721,10,287
세현정공,39033,801,1784,796,1784,5,86
세화파렛텍,90216,47,36,47,36,0,2
센타빌딩,39902,11744,12231,11605,12231,139,799
센트럴공원,38490,1058,2944,1047,2944,11,133
센트럴파크역,38397,9632,1300,9613,1300,19,364
센트럴파크역,38574,1988,3010,1981,3010,7,166
센트럴파크푸르지오아파트,38544,1806,1232,1797,1232,9,101
센트럴파크푸르지오아파트,38545,883,1663,855,1663,28,84
셀트리온(주),38319,241,657,240,657,1,29
셀트리온(주)앞,38513,509,346,496,346,13,28
셀트리온2공장앞,38474,675,655,673,655,2,44
셀트리온2공장앞,38475,1366,634,1360,634,6,66
소게,43185,3,121,3,121,0,4
소게,43243,89,2,89,2,0,3
소구월사거리,39266,5699,12195,5614,12195,85,596
소구월사거리,39268,4852,3720,4615,3720,237,285
소나무,43396,46,0,46,0,0,1
소나무,43805,0,28,0,28,0,0
소담(장미)마을입구,90236,0,2,0,2,0,0
소담(장미)마을입구,90237,10,0,10,0,0,0
소동,43412,148,2,133,2,15,5
소동,43829,1,183,1,183,0,6
소래도서관,39829,18,797,7,797,11,27
소래산등산로입구,39770,2,117,2,117,0,3
소래산등산로입구,39771,47,0,47,0,0,1
소래산입구,39668,45,698,45,698,0,24
소래산입구,39670,1328,115,1321,115,7,48
소래역사관,39816,317,1407,302,1407,15,57
소래역사관,39817,2169,141,2132,141,37,77
소래초등학교,39615,176,275,176,275,0,15
소래포구,39815,1303,102,1278,102,25,46
소래포구,39818,262,3251,253,3251,9,117
소래포구역,39647,3871,1736,3816,1736,55,186
소래포구역,39648,1867,5545,1844,5545,23,247
소래포구역,39710,3210,1526,3086,1526,124,157
소래포구역앞,92063,1797,1276,1787,1276,10,102
소래포구역종점,39793,765,40,726,40,39,26
소래포구입구,70009,1036,137,1011,137,25,39
소래포구입구(논현푸르지오A),39109,353,1395,349,1395,4,58
소래포구입구(논현푸르지오A),39114,357,189,346,189,11,18
소래풍림아파트,39122,2848,783,2781,783,67,121
소리공원(하모니로),38721,347,756,344,756,3,36
소리공원(하모니로),38722,324,316,319,316,5,21
소망탑빌라,40116,12,296,12,296,0,10
소방대앞,90022,5,21,5,21,0,0
소방대앞,90023,115,17,113,17,2,4
소산서원,70011,190,826,189,826,1,33
소산서원,70012,327,422,312,422,15,24
소장전,43996,6,17,5,17,1,0
소장전,43997,14,6,14,6,0,0
소촌마을,41662,120,19,120,19,0,4
속아지,43344,24,0,18,0,6,0
속아지,43848,2,22,2,22,0,0
솔밭마을,38193,705,326,688,326,17,34
솔빛마을,36034,9257,8910,9068,8910,189,605
솔빛마을,36037,5959,6793,5792,6793,167,425
솔빛마을주공아파트,36049,10768,7668,10469,7668,299,614
솔빛마을주공아파트,36050,10066,12141,9890,12141,176,740
솔빛주공2단지,36045,1092,818,1059,818,33,63
솔안공원,38348,11551,6539,11378,6539,173,603
솔정,43526,24,0,11,0,13,0
솔정,43871,0,21,0,21,0,0
솔정1리마을회관,90085,0,7,0,7,0,0
솔정1리마을회관,90086,6,0,6,0,0,0
솔정마을,43129,38,6,24,6,14,1
솔정마을,43811,20,0,18,0,2,0
솔정마을,43872,3,13,3,13,0,0
솔정마을,90108,0,7,0,7,0,0
솔정정미소,43130,12,27,11,27,1,1
솔정정미소,43134,63,2,45,2,18,2
솔터마을입구,80327,1282,306,1275,306,7,52
솔터마을입구,80336,1238,1201,1229,1201,9,81
솔펜션,44143,1,8,1,8,0,0
솔펜션,44177,8,2,8,2,0,0
송곡촌,43439,9,47,9,47,0,1
송곡촌,43815,78,17,78,17,0,3
송내고교입구,11014,63,362,61,362,2,14
송내고교입구,11015,661,150,659,150,2,27
송내고등학교,40219,2700,2578,2628,2578,72,175
송내남부역,40761,53,1142,52,1142,1,39
송내역.로데오거리,55267,4925,28580,4856,28580,69,1116
송내역.영화의거리,55263,24561,6737,24164,6737,397,1043
송내역남부,56002,96567,38426,96309,38426,258,4499
송내역남부,56005,110254,97961,109455,97961,799,6940
송담초등학교,38667,1949,693,1885,693,64,88
송담초등학교,38668,811,1820,799,1820,12,87
송도1동행정복지센터,38012,5397,12888,5318,12888,79,609
송도2동행정복지센터,38492,4847,2777,4792,2777,55,254
송도2동행정복지센터,38588,829,2023,818,2023,11,95
송도MTB파크,38746,172,228,166,228,6,13
송도SK뷰(101동),38635,475,114,471,114,4,19
송도SK뷰(105동),38632,63,249,50,249,13,10
송도SK뷰(105동),38633,775,125,771,125,4,30
송도sk뷰,38707,910,2515,845,2515,65,114
송도sk뷰,38708,315,1545,301,1545,14,62
송도고입구,38215,2908,2905,2764,2905,144,193
송도고입구,38221,3204,1208,3077,1208,127,147
송도공영차고지,38472,417,29,377,29,40,14
송도국제교입구,38597,102,0,102,0,0,3
송도글로벌캠퍼스푸르지오아파트,38711,661,537,657,537,4,39
송도누리공원,38663,3017,4196,2975,4196,42,240
송도누리공원,38664,948,2695,932,2695,16,121
송도달빛축제공원역,38696,13997,2812,13881,2812,116,560
송도달빛축제공원역,38697,2583,13051,2564,13051,19,521
송도더삽그린워크(3차),38530,117,243,111,243,6,12
송도더샵그린스퀘어,39843,4336,1641,4299,1641,37,199
송도더샵그린워크,38526,1427,497,1391,497,36,64
송도더샵그린워크2차,38493,2281,3399,2256,3399,25,189
송도더샵그린워크3차18블럭,38719,180,571,178,571,2,25
송도더샵마스터뷰21단지,38578,3810,432,3732,432,78,141
송도더샵마스터뷰22단지,38693,968,380,949,380,19,44
송도더샵마스터뷰22단지(2202동),38698,107,252,94,252,13,11
송도더샵마스터뷰22단지(2202동),38712,198,499,198,499,0,23
송도더샵마스터뷰22단지(정문),38694,232,1036,232,1036,0,42
송도더샵마스터뷰22단지(하행),38695,222,1012,214,1012,8,41
송도더샵마스터뷰23단지,38441,3942,5003,3837,5003,105,298
송도더샵마스터뷰23단지,38442,569,7195,564,7195,5,258
송도더샵마스터뷰23단지(정문),38692,1356,171,1344,171,12,50
송도더샵센트럴시티,39842,2732,3708,2694,3708,38,214
송도더샵센트럴시티.글로벌캠퍼스푸르지오,38647,4212,1063,4202,1063,10,175
송도더샵퍼스트월드,38589,881,1093,868,1093,13,65
송도더샵퍼스트월드(동문),38013,16263,6533,16175,6533,88,759
송도더샵퍼스트월드(서문),38381,2931,930,2886,930,45,128
송도더샵퍼스트월드B동.C동,38425,4227,2061,4157,2061,70,209
송도더샵퍼스트월드D동,38009,1745,1971,1722,1971,23,123
송도더샵퍼스트파크14단지,38560,683,2360,645,2360,38,101
송도더샵퍼스트파크14단지,38577,1995,331,1971,331,24,77
송도더샵퍼스트파크15단지,38559,187,740,180,740,7,30
송도더샵퍼스트파크15단지,38576,840,137,800,137,40,32
송도더샵하버뷰2차,38467,2442,13298,2410,13298,32,524
송도동일하이빌파크포레아파트,38680,2844,946,2802,946,42,126
송도라마다호텔앞,38065,2376,4628,2298,4628,78,233
송도라마다호텔앞,38067,12400,8413,12187,8413,213,693
송도랜드마크시티13호근린공원,38738,72,541,72,541,0,20
송도랜드마크시티13호근린공원,38739,278,235,277,235,1,17
송도랜드마크푸르지오시티,38747,413,1175,400,1175,13,52
송도베르디움더퍼스트후문,39985,865,4238,855,4238,10,170
송도세브란스병원,38651,42,797,42,797,0,27
송도센트럴파크,38452,1627,6547,1625,6547,2,272
송도센트럴파크역,38563,2598,851,2555,851,43,114
송도소방서(송도스마트밸리),39801,2175,2605,2171,2605,4,159
송도스마트밸리,39802,4216,2141,4214,2141,2,211
송도스포츠센터(LNG야구장),39721,1762,1321,1731,1321,31,102
송도아트윈푸르지오,38549,446,485,435,485,11,31
송도아트윈푸르지오,38562,1,219,0,219,1,7
송도에듀포레푸르지오,39921,1179,4692,1149,4692,30,195
송도에듀포레푸르지오후문,39986,4418,565,4363,565,55,166
송도역,38213,2327,6414,2319,6414,8,291
송도역,38505,8638,12362,8492,12362,146,700
송도역,38669,579,1223,575,1223,4,60
송도영남아파트,38224,10709,7721,10566,7721,143,614
송도오션파크베르디움,38642,1040,14433,992,14433,48,515
송도요양원,38144,1700,2036,1665,2036,35,124
송도유원지(도로교통공단),38081,10156,12910,10016,12910,140,768
송도유원지(도로교통공단),38088,16884,7009,16542,7009,342,796
송도자이하버뷰,38521,3735,1545,3706,1545,29,176
송도자이하버뷰1단지,38468,16248,2905,16168,2905,80,638
송도자이하버뷰2단지(202동),38488,2511,3855,2407,3855,104,212
송도자이하버뷰2단지(205동),38455,587,693,583,693,4,42
송도자이하버뷰2단지(정문),38465,2042,1041,2016,1041,26,102
송도자이하버뷰2단지(정문),38498,1180,1814,1152,1814,28,99
송도재래시장,38207,6260,7994,6076,7994,184,475
송도재래시장,38210,7802,5924,7625,5924,177,457
송도재래시장,38220,5472,2758,5373,2758,99,274
송도제2차고지,38703,425,12,286,12,139,14
송도제2차고지입구,38735,426,916,354,916,72,44
송도중학교,35155,13271,15034,12624,15034,647,943
송도지웰푸르지오시티,38424,5566,8354,5538,8354,28,464
송도채석장,38175,739,2646,728,2646,11,112
송도체육센터,38699,76,657,76,657,0,24
송도체육센터,38700,678,147,661,147,17,27
송도컨벤시아,38367,1672,6477,1651,6477,21,271
송도컨벤시아,38369,2685,1224,2636,1224,49,130
송도컨벤시아남문,38660,2026,1062,1986,1062,40,102
송도컨벤시아남문,38661,883,1900,875,1900,8,92
송도타임스페이스,38720,794,2091,794,2091,0,96
송도테크노파크IT센터,39929,5782,4024,5770,4024,12,326
송도파크레인동일하이빌,38625,42,86,41,86,1,4
송도파크레인동일하이빌,38626,820,18,814,18,6,27
송도파크레인입구,38538,468,3153,458,3153,10,120
송도파크레인입구,38539,1294,1411,1275,1411,19,90
송도파크자이,38627,869,465,860,465,9,44
송도파크자이,38628,14,755,14,755,0,25
송도파크자이아파트,38638,8866,7580,8679,7580,187,548
송도파크자이아파트정문,38677,1119,4677,1092,4677,27,193
송도푸르지오월드마크,38426,4740,6184,4657,6184,83,364
송도푸르지오하버뷰,38494,3664,4255,3584,4255,80,263
송도풍림아이원1단지,38033,3239,23191,3134,23191,105,881
송도풍림아이원2단지,38025,7407,15553,7120,15553,287,765
송도풍림아이원2단지,38026,9521,4736,9391,4736,130,475
송도풍림아이원2단지,38034,25059,3236,24768,3236,291,943
송도풍림아이원4단지,38032,3445,8907,3328,8907,117,411
송도힐스테이트,38479,13774,7087,13552,7087,222,695
송도힐스테이트5단지,38393,5821,7982,5754,7982,67,460
송도힐스테이트6단지,38554,21,115,21,115,0,4
송동마을.서초힐스아파트,22962,1137,195,1135,195,2,44
송림119안전센터,36165,83,202,79,202,4,9
송림3.5동행정복지센터(재능대정문),36030,1630,9105,1626,9105,4,357
송림4동행정복지센터(재능대후문),36127,226,723,226,723,0,31
송림고가교,37491,2079,1375,2060,1375,19,115
송림고가교,37492,968,1849,949,1849,19,93
송림고개(도화신동아아파트),37439,7897,8781,7714,8781,183,555
송림고개(도화신동아아파트),37501,11962,7174,11839,7174,123,637
송림동진로아파트,36154,260,398,256,398,4,21
송림동진로아파트,36155,134,800,126,800,8,31
송림빌라,43316,58,0,56,0,2,1
송림빌라,43775,1,29,1,29,0,1
송림시장,36015,274,348,267,348,7,20
송림오거리,36131,15125,3968,14935,3968,190,636
송림오거리,36132,3563,9535,3480,9535,83,436
송림주공아파트,36171,12,10,12,10,0,0
송림주공아파트,36176,1,7,1,7,0,0
송림주유소,36090,640,403,617,403,23,34
송림체육관,36130,617,32,605,32,12,21
송림체육관,36148,5,345,3,345,2,11
송림체육관후문,36152,135,795,133,795,2,31
송림체육관후문,36153,593,182,585,182,8,25
송림휴먼시아,36124,17,656,16,656,1,22
송림휴먼시아,36125,139,2225,135,2225,4,78
송림휴먼시아정문,36164,55,0,55,0,0,1
송림휴먼시아정문,36180,1,47,1,47,0,1
송마3리,80157,560,36,549,36,11,19
송마3리,80158,38,339,34,339,4,12
송마리입구,80159,33,731,24,731,9,25
송마리입구,80160,443,154,427,154,16,19
송명초등학교,92013,2761,261,2724,261,37,100
송산,43482,69,26,69,26,0,3
송산,43710,40,54,40,54,0,3
송산교회,43956,1,56,1,56,0,1
송산삼거리,43480,31,3,24,3,7,1
송산삼거리,43611,6,25,0,25,6,1
송암박두성생가입구,90396,0,33,0,33,0,1
송암박두성생가입구,90397,17,0,16,0,1,0
송월동동화마을,35189,7109,3747,6894,3747,215,361
송월동동화마을,35190,3796,8727,3732,8727,64,417
송월아파트,35193,2954,680,2898,680,56,121
송월아파트,35194,1042,3192,1003,3192,39,141
송정역,25184,60,3016,49,3016,11,102
송정역,25185,4924,66,4867,66,57,166
송학둥지아파트,38584,3372,3451,3277,3451,95,227
송학둥지아파트,38585,1875,4357,1793,4357,82,207
송해교회,43384,274,99,258,99,16,12
송해교회,43769,74,292,72,292,2,12
송해면사무소,43708,30,140,29,140,1,5
송해면사무소,43809,100,35,93,35,7,4
송해삼거리,43386,346,71,337,71,9,13
송해삼거리,43819,119,440,110,440,9,18
송해초등학교,43807,3,114,3,114,0,3
송해초등학교,43820,82,20,77,20,5,3
송현시장.수도국산달동네박물관,36019,6016,5348,5737,5348,279,378
송현시장.수도국산달동네박물관,36020,5723,20836,5544,20836,179,885
송현시장.수도국산달동네박물관,36025,36,522,30,522,6,18
송현아파트,36065,6173,3585,6011,3585,162,325
송현아파트,36067,2184,4946,2135,4946,49,237
송현주공아파트,36073,1100,3165,1077,3165,23,142
송현주공아파트,36080,11948,5567,11600,5567,348,583
송현주공아파트후문,36162,615,2524,609,2524,6,104
쇠골큰말,89318,45,37,45,37,0,2
쇠골큰말,89321,112,20,98,20,14,4
수곡(월곳리),43191,47,1,44,1,3,1
수곡(월곳리),43620,0,32,0,32,0,1
수광티티아이,90215,22,27,22,27,0,1
수도군수지원단(장애인복지관),40825,6064,1619,5968,1619,96,256
수도군수지원단(장애인복지관),40826,49,2025,39,2025,10,69
수림공원,39347,2085,797,2032,797,53,96
수림공원,39351,795,1858,794,1858,1,88
수변로삼거리,40367,979,557,957,557,22,51
수변로삼거리,40370,2581,4979,2566,4979,15,252
수봉공원,37289,2266,1298,2232,1298,34,118
수봉공원,37569,1102,3780,1092,3780,10,162
수봉공원.인천수봉문화회관입구,37362,12936,6703,12498,6703,438,654
수봉공원.인천수봉문화회관입구,37369,9001,13215,8822,13215,179,740
수봉마을쉼터,37570,3411,3111,3308,3111,103,217
수봉마을쉼터,37571,2575,1847,2541,1847,34,147
수부촌,43041,132,211,127,211,5,11
수산동,39175,404,878,401,878,3,42
수산동,39176,404,526,403,526,1,31
수양관,43245,17,34,15,34,2,1
수양관,43645,44,6,39,6,5,1
수인곡물시장,35134,2328,2567,2226,2567,102,163
수정제입구,90290,5,7,5,7,0,0
수촌,43111,90,4,88,4,2,3
수촌,43358,3,66,3,66,0,2
수출산업단지6공단입구,40009,3574,4305,3517,4305,57,262
수출산업단지6공단입구,40010,1936,2526,1923,2526,13,148
수행마을.홈플러스,80074,650,15,648,15,2,22
수행마을.홈플러스,80075,93,539,93,539,0,21
수현마을,39487,2617,3657,2569,3657,48,209
수현마을,39488,6101,4958,5977,4958,124,368
수협,43059,0,2,0,2,0,0
수협,43060,179,1249,171,1249,8,47
수협,43062,3407,9233,3275,9233,132,421
수협(인천해양센터),35080,3303,107,3153,107,150,113
수협(인천해양센터),35081,106,5509,104,5509,2,187
순복음교회,37253,9419,26011,9157,26011,262,1181
순복음교회,39181,18602,8070,18084,8070,518,889
순복음교회,40661,12024,5617,11947,5617,77,588
순천향대학병원.부명고,55037,8547,1012,8440,1012,107,318
숭덕여중고입구,39461,13233,24330,13066,24330,167,1252
숭덕여중고입구,39463,16140,12038,15823,12038,317,939
숭덕여중고입구,39466,6996,1271,6897,1271,99,275
숭뢰2리,43421,129,217,122,217,7,11
숭뢰2리,43704,169,59,160,59,9,7
숭보사입구,40851,148,40,147,40,1,6
숭보사입구,40918,6,95,2,95,4,3
숭의1.3동(극동아파트),37328,906,1416,871,1416,35,77
숭의1.3동(극동아파트),37337,1248,1338,1186,1338,62,86
숭의2동행정복지센터,37563,1685,2019,1665,2019,20,123
숭의교회,37269,18351,10958,17996,10958,355,976
숭의교회,37271,13549,15360,13212,15360,337,963
숭의로터리,37265,6739,18890,6564,18890,175,854
숭의로터리,37266,17101,5568,16808,5568,293,755
숭의로터리,37273,18492,9294,18138,9294,354,926
숭의로터리.도원체육관,37276,9277,13917,9024,13917,253,773
숭의목공예마을앞,37313,8680,7925,8441,7925,239,553
숭의목공예마을앞,37315,5485,6403,5362,6403,123,396
숭의박문아파트,37353,2392,3556,2349,3556,43,198
숭의박문아파트,37354,3530,2260,3471,2260,59,193
숭의보건지소,37532,14514,3637,14313,3637,201,605
숭의역(1번출구),37510,43591,21987,42932,21987,659,2185
숭의역(2번출구),37211,27273,33820,26993,33820,280,2036
숭의역(3번출구),35133,1069,2678,1050,2678,19,124
숭의역(4번출구),35135,3556,2547,3462,2547,94,203
숭의초등학교,37296,961,684,923,684,38,54
숭의초등학교,37308,1387,3376,1373,3376,14,158
숭의초등학교입구,37287,1650,1807,1611,1807,39,115
쉐보레인천서비스,40433,1680,4224,1665,4224,15,196
쉐보레출고사무소,89160,1947,18,1881,18,66,65
쉴낙원인천장례식장,41458,945,1915,927,1915,18,95
스카이시티자이.화성파크드림,35650,2315,6098,2259,6098,56,280
스타파이브입구,35428,304,67,289,67,15,12
스타파이브입구,35429,36,285,36,285,0,10
스태츠칩팩코리아,35641,5,405,5,405,0,13
스태츠칩팩코리아,35642,429,3,422,3,7,14
스틸랜드,70228,167,443,165,443,2,20
스틸랜드,70229,413,133,403,133,10,18
스포월드골프연습장,42439,86,252,84,252,2,11
스포월드골프연습장,42440,16,125,16,125,0,4
승기천,39169,1068,6118,1049,6118,19,239
승기천,39170,582,4664,577,4664,5,174
시대아파트,38340,16303,12619,16073,12619,230,964
시리미,43330,39,42,36,42,3,2
시리미,43631,15,0,15,0,0,0
시립가좌테니스장,37581,150,1174,150,1174,0,44
시립가좌테니스장,37582,163,2393,163,2393,0,85
시민공원,37359,13555,5137,13184,5137,371,623
시민공원(문화창작지대)역,37344,20581,18594,20305,18594,276,1305
시민공원(문화창작지대)역,37346,31360,29969,30837,29969,523,2044
시민공원.문화창작지대,37334,17751,30260,17327,30260,424,1600
시민공원.문화창작지대,37468,1660,1504,1614,1504,46,105
시민공원역.포레나미추홀,37319,8469,56079,8376,56079,93,2151
시민공원역.포레나미추홀,37326,79758,17463,78783,17463,975,3240
시민의숲.양재꽃시장,31002,14171,4191,14154,4191,17,612
시민의숲.양재꽃시장,31003,1340,3557,1336,3557,4,163
시장로터리(중앙철재),40261,2515,2046,2495,2046,20,152
시청광장입구,39217,17077,20755,16769,20755,308,1261
시청광장입구,39218,20422,16949,20249,16949,173,1245
시흥대야역.영남아파트,70027,378,1470,375,1470,3,61
시흥대야역.영남아파트,70028,1448,445,1391,445,57,63
시흥보건소,70015,1941,417,1919,417,22,78
시흥보건소,70016,455,1730,445,1730,10,72
시흥영업소,25846,159,70,159,70,0,7
시흥영업소,25847,65,145,65,145,0,7
신골입구,43998,23,44,19,44,4,2
신골입구,43999,26,12,26,12,0,1
신광주유소,43470,1,0,1,0,0,0
신광주유소,43524,3,8,3,8,0,0
신광초등학교,35142,528,375,506,375,22,30
신기.남부종합시장(진흥사거리),37217,52201,28674,51217,28674,984,2695
신기.남부종합시장(진흥사거리),37219,16389,30115,16011,30115,378,1550
신김포농협대곶지점,80147,53,33,53,33,0,2
신김포농협대곶지점,80148,144,223,139,223,5,12
신논현역,32055,10862,63,10855,63,7,364
신논현역.우신빌딩,31057,79,6004,79,6004,0,202
신당리동촌부락,90090,6,1,6,1,0,0
신당리동촌부락,90091,1,1,1,1,0,0
신당리마을회관,90087,0,2,0,2,0,0
신당촌,90114,9,4,9,4,0,0
신대진중앙아파트,41271,3775,2932,3732,2932,43,223
신대진중앙아파트,41274,2068,3486,2057,3486,11,185
신도실업(주),40625,636,1771,629,1771,7,80
신동마을,90253,0,2,0,2,0,0
신동마을,90254,12,28,6,28,6,1
신동아1.2차아파트,37507,9964,6257,9803,6257,161,540
신동아1단지,70038,147,195,127,195,20,11
신동아1단지.한일아파트,70037,180,99,179,99,1,9
신동아3차아파트,37119,12046,16026,11863,16026,183,935
신동아3차아파트,37120,11087,18969,10970,18969,117,1001
신동아3차아파트,37494,11660,5955,11470,5955,190,587
신동아상가,40860,5601,4063,5561,4063,40,322
신동아상가(백운역방면),40068,5517,7357,5417,7357,100,429
신동아아파트,37072,15,1084,14,1084,1,36
신동아아파트,37143,9065,13916,8894,13916,171,766
신동아아파트,37160,5902,7570,5754,7570,148,449
신동아아파트,37525,2242,7929,2166,7929,76,339
신동아아파트,39381,3252,7443,3234,7443,18,356
신동아아파트,39382,17338,6623,17181,6623,157,798
신동아아파트,41349,8013,953,7987,953,26,298
신동아아파트,41350,1444,7298,1439,7298,5,291
신동아아파트(B),37162,11637,10528,11428,10528,209,738
신동아아파트116동,40060,3438,11292,3371,11292,67,491
신동아아파트116동,40859,7307,2875,7280,2875,27,339
신동아아파트3차,37090,10700,1065,10530,1065,170,392
신동아아파트3차,37097,3580,9496,3489,9496,91,435
신동아아파트4차,37121,4905,1733,4835,1733,70,221
신동아아파트4차,37123,2345,3568,2315,3568,30,197
신동아아파트5차,37141,12891,4130,12726,4130,165,567
신동아아파트8차,37135,1627,3386,1602,3386,25,167
신동아아파트8차,37136,5024,1181,4959,1181,65,206
신동양아파트,41202,3297,8955,3287,8955,10,408
신동양아파트,41203,8464,3927,8379,3927,85,413
신라아파트,37277,7094,6501,6937,6501,157,453
신라아파트,37543,1794,4195,1745,4195,49,199
신명보람마을.삼부한신아파트,40511,2248,2983,2201,2983,47,174
신명보람마을.삼부한신아파트,40512,710,964,702,964,8,55
신명스카이뷰,35453,1429,2292,1390,2292,39,124
신명스카이뷰,35456,5914,4542,5795,4542,119,348
신명스카이뷰,42737,129,251,127,251,2,12
신명스카이뷰정문,35455,5560,6147,5475,6147,85,390
신명아파트,42081,8527,12053,8290,12053,237,686
신명아파트.대우3차아파트,70018,427,2911,412,2911,15,111
신명아파트앞,42799,11,1249,10,1249,1,42
신반포역.세화여중고,31033,834,73,832,73,2,30
신봉삼거리,43126,92,11,90,11,2,3
신봉삼거리,43127,4,15,4,15,0,0
신봉삼거리,43463,972,768,906,768,66,58
신봉삼거리,43814,2,9,2,9,0,0
신봉이발관,43458,43,2,38,2,5,1
신봉이발관,43786,6,52,6,52,0,1
신북항고가교,42104,2947,2387,2895,2387,52,177
신북항고가교,42109,2243,2751,2194,2751,49,166
신분당선.강남역4번출구,23572,9830,2340,9812,2340,18,405
신비마을아파트,37164,295,1843,282,1843,13,71
신비마을아파트,37223,5108,7985,5046,7985,62,436
신비마을아파트,37225,6975,4697,6875,4697,100,389
신비마을아파트,37555,446,1397,442,1397,4,61
신비마을아파트(112동),37171,5435,3630,5328,3630,107,302
신삼1리마을회관,43405,141,0,133,0,8,4
신삼1리마을회관,43791,4,122,4,122,0,4
신삼2리마을회관,43400,94,1,81,1,13,3
신삼2리마을회관,43825,12,87,12,87,0,3
신삼리입구,43606,11,8,10,8,1,0
신삼리입구,43801,14,41,14,41,0,1
신선지입구,90346,8,0,8,0,0,0
신선지입구,90347,10,28,10,28,0,1
신선초등학교,35086,5973,10028,5883,10028,90,533
신선초등학교(유림노르웨이숲),35089,6583,3270,6507,3270,76,328
신선초등학교앞,37055,2780,998,2668,998,112,125
신설동,35413,12,51,12,51,0,2
신설동,35416,34,18,34,18,0,1
신설동(3거리),35018,144,13,141,13,3,5
신설동(3거리),35019,10,193,10,193,0,6
신성미소지움,40099,3029,47,2788,47,241,102
신성미소지움,40102,74,2118,21,2118,53,73
신성미소지움,40643,1758,12857,1744,12857,14,487
신성미소지움,40649,6959,2086,6862,2086,97,301
신성미소지움후문,40660,4,371,4,371,0,12
신성성결교회(올림피아병원),39355,12978,8351,12898,8351,80,710
신세계아파트,39383,3305,5089,3248,5089,57,279
신송고등학교,38023,1799,3371,1728,3371,71,172
신송고등학교,38024,3312,2400,3199,2400,113,190
신안실크밸리,35220,845,263,838,263,7,36
신연수역(1번출구),38263,4072,3587,4047,3587,25,255
신연수역(2번출구),38231,2865,697,2846,697,19,118
신연수역(3번출구),38228,5305,4427,5237,4427,68,324
신영자동차,40561,3910,642,3863,642,47,151
신영자동차(종점),40556,5366,2527,5196,2527,170,263
신왕마을,43203,169,8,166,8,3,5
신왕마을,43718,0,87,0,87,0,2
신원기술,39130,44,19,44,19,0,2
신원아침도시오피스텔(홈플러스),39836,5790,6057,5751,6057,39,394
신일교회,39529,4758,6913,4672,6913,86,389
신일아파트,35097,19,11,19,11,0,1
신정1리마을회관,43300,21,8,21,8,0,0
신정1리마을회관,43737,29,9,21,9,8,1
신정삼거리,90111,0,8,0,8,0,0
신정삼거리,90112,5,0,4,0,1,0
신정중학교,38459,948,1188,931,1188,17,71
신정중학교,38555,1536,567,1493,567,43,70
신중동역4번출구.롯데백화점,55226,1666,6328,1662,6328,4,266
신중동역5번출구.중흥중학교,55071,772,5988,771,5988,1,225
신중동역6번출구.중흥중학교,55072,3053,462,3052,462,1,117
신지동마을회관,43303,78,37,73,37,5,3
신지동마을회관,43740,51,34,40,34,11,2
신진아파트,41107,24643,13550,24482,13550,161,1273
신창아파트,37010,3820,6675,3368,6675,452,349
신창아파트,37464,5459,1956,5380,1956,79,247
신천동,70048,6824,527,6582,527,242,245
신천동,70049,354,6900,345,6900,9,241
신천삼거리,70013,6884,423,6715,423,169,243
신천삼거리,70014,449,6778,435,6778,14,240
신천역.문화의거리,25364,1189,371,1178,371,11,52
신천역.문화의거리,70174,230,1168,209,1168,21,46
신천연합병원,70175,70,778,63,778,7,28
신천연합병원,70231,807,229,791,229,16,34
신촌,43146,30,1,30,1,0,1
신촌,43432,12,12,12,12,0,0
신촌,43459,253,17,244,17,9,9
신촌,43510,0,15,0,15,0,0
신촌,43753,19,179,19,179,0,6
신촌,43800,51,43,51,43,0,3
신촌마을입구,90201,37,6,37,6,0,1
신촌마을입구,90202,5,6,4,6,1,0
신촌역2호선,22052,5028,59,5018,59,10,169
신촌오거리.2호선신촌역,22014,6708,111,6707,111,1,227
신촌오거리.2호선신촌역,23035,98,3270,98,3270,0,112
신촌오거리.현대백화점,22013,12006,216,11996,216,10,407
신촌오거리.현대백화점,23034,345,15616,345,15616,0,532
신촌초등학교,40098,255,949,255,949,0,40
신태양아파트,37406,6052,7515,6018,7515,34,452
신태양아파트,37408,9129,4047,9091,4047,38,439
신트리공원,40472,2267,2581,2211,2581,56,161
신트리공원,40496,2505,4213,2451,4213,54,223
신트리공원,40501,2191,1598,2168,1598,23,126
신포동행정복지센터,35153,3945,2432,3897,2432,48,212
신포동행정복지센터,35154,2177,3504,2079,3504,98,189
신포사거리,35791,47,196,41,196,6,8
신포시장,35160,32998,52020,32404,52020,594,2833
신포시장,35254,54634,32850,53476,32850,1158,2916
신포역·인천세관역사공원,35792,258,143,255,143,3,13
신포역·인천세관역사공원,35796,12,14,10,14,2,0
신포역·인천여자상업고등학교,35149,1694,7493,1599,7493,95,306
신포역·인천여자상업고등학교,35150,7236,2822,7190,2822,46,335
신포입구,43491,66,46,61,46,5,3
신포입구,43842,36,21,31,21,5,1
신한빌딩,39901,9860,9339,9701,9339,159,639
신한에이엠,89147,408,20,404,20,4,14
신한일전기,39034,1679,1015,1677,1015,2,89
신현119안전센터,42596,10063,13827,9853,13827,210,796
신현119안전센터,42600,8158,9803,7996,9803,162,598
신현노인회관,43279,57,8,55,8,2,2
신현노인회관,43527,6,63,5,63,1,2
신현리입구,90062,27,69,26,69,1,3
신현북초등학교,42208,4469,330,4403,330,66,159
신현북초등학교,42209,288,3373,284,3373,4,122
신현북초등학교,42210,1813,304,1781,304,32,70
신현북초등학교,42211,68,1697,64,1697,4,58
신현쇼핑,42217,35006,28839,34120,28839,886,2128
신현쇼핑,42220,46094,24369,45331,24369,763,2348
신현여자중학교후문,42214,3316,3979,3206,3979,110,243
신현여자중학교후문,42680,3373,1806,3299,1806,74,172
신현중학교,42205,120,3482,112,3482,8,120
신현초등학교,42178,1756,1924,1642,1924,114,122
신현초등학교,42179,2028,3278,1949,3278,79,176
신화빌라,42626,514,422,513,422,1,31
신화슈퍼,89314,153,0,139,0,14,5
신화슈퍼,89326,3,296,3,296,0,9
신흥교통,35501,219,4,165,4,54,7
신흥교통입구,35841,1514,34,1460,34,54,51
신흥동주민자치센터,35789,160,59,159,59,1,7
신흥동주민자치센터,35799,56,13,46,13,10,2
신흥시장,35145,12387,15313,12013,15313,374,923
신흥시장,35146,17476,9223,16844,9223,632,889
신흥시장,57002,3050,1330,2963,1330,87,146
신흥시장,57004,1870,2837,1835,2837,35,156
신흥시장후문,35812,78,51,75,51,3,4
신흥시장후문,35813,81,96,78,96,3,5
신흥주민지원센터,57013,3476,1977,3416,1977,60,181
신흥주민지원센터,57014,1856,3121,1840,3121,16,165
신흥초등학교,35156,8221,10237,7974,10237,247,615
실내게이트볼장(신현중학교),42204,5196,125,5097,125,99,177
실미도조개구이,35299,9,45,9,45,0,1
실미삼거리,35740,527,117,510,117,17,21
실미삼거리,35741,60,376,60,376,0,14
심곡극동아파트,42272,1926,382,1887,382,39,76
심곡극동아파트,42273,290,1168,276,1168,14,48
심곡도서관,42946,1747,1259,1707,1259,40,100
심곡도서관,89223,590,2142,584,2142,6,91
심곡동광명아파트,89153,6099,2675,5909,2675,190,292
심곡동광명아파트,89154,2558,4090,2512,4090,46,221
심곡천(심곡3교),89381,71,1,69,1,2,2
심곡천(심곡3교),89382,4,160,2,160,2,5
심곡천봉수교,42875,617,651,610,651,7,42
심곡천봉수교,42951,1483,5017,1443,5017,40,216
심곡초등학교(국제성모병원),42288,4068,5603,4007,5603,61,322
심곡초등학교(국제성모병원),42290,5889,4227,5791,4227,98,337
심팩이엔지,89387,0,23,0,23,0,0
십리포제2주차장,44110,47,35,43,35,4,2
십리포해수욕장,44088,116,145,114,145,2,8
십정1동행정복지센터,40049,17865,13648,17720,13648,145,1050
십정2동행정복지센터,40056,5757,6531,5690,6531,67,409
십정동차고지,40913,2626,237,2571,237,55,95
십정사거리,40029,6439,5371,6385,5371,54,393
십정사거리,40033,3174,3365,3137,3365,37,217
십정시장입구,40007,20,3707,9,3707,11,124
십정시장입구,40008,3794,22,3786,22,8,127
십정초등학교(동암의원),40041,1170,1019,1143,1019,27,72
십정초등학교(동암의원),40042,604,2273,596,2273,8,95
십정초등학교·더샵부평정문,40045,17600,18977,17374,18977,226,1219
십정초등학교·더샵부평정문,40048,23833,19132,23668,19132,165,1432
쌍마아파트,42112,6393,3388,6182,3388,211,326
쌍마아파트,42114,565,2435,542,2435,23,100
쌍용아파트,37179,5222,2654,5121,2654,101,262
쌍용아파트,37186,1895,3916,1795,3916,100,193
쌍용아파트,37210,647,448,639,448,8,36
쌍용아파트,37228,21659,12049,21246,12049,413,1123
쌍용아파트,37476,14510,22577,14304,22577,206,1236
쌍용아파트,38178,466,800,466,800,0,42
쌍용아파트,38184,636,171,603,171,33,26
쌍용아파트,38469,4808,2921,4635,2921,173,257
쌍용아파트,41434,1336,4232,1322,4232,14,185
쌍용아파트정문,40439,2253,3648,2235,3648,18,196
쌍용자동차인천정비사업소,36144,54,815,50,815,4,28
쑥골고가교,37371,3072,3301,3013,3301,59,212
쑥골고가교,37372,5770,8351,5640,8351,130,470
쑥밭다리,43650,32,2,29,2,3,1
쑥밭다리,43683,5,8,5,8,0,0
아나지고개,41001,2240,2964,2208,2964,32,173
아나지고개,41002,3607,5301,3555,5301,52,296
아동보호센터,35680,67,201,65,201,2,8
아동보호센터,35698,52,25,52,25,0,2
아라노을공원·한신더휴,89404,8514,4847,8490,4847,24,445
아라노을공원·한신더휴,89405,6048,8052,5866,8052,182,470
아라동행정복지센터,42465,6588,12013,6449,12013,139,620
아라동행정복지센터,42467,9797,5196,9754,5196,43,499
아라동행정복지센터(서부고용센터),89401,2710,507,2696,507,14,107
아라동행정복지센터(서부고용센터),89402,565,3941,565,3941,0,150
아라뱃길물류센터,89145,1,212,1,212,0,7
아라센트럴파크,89406,2308,4736,2280,4736,28,234
아라센트럴파크,89407,5310,3361,5258,3361,52,289
아름어린이공원,40337,270,365,262,365,8,21
아름어린이공원,40339,470,472,462,472,8,31
아리마을쉼터,37551,19,1078,19,1078,0,36
아리마을쉼터,37552,1377,265,1299,265,78,54
아모텍,39139,1488,2101,1483,2101,5,119
아시아드경기장(공촌사거리)역,42319,2363,4168,2333,4168,30,217
아시아드경기장(공촌사거리)역,42320,482,1551,451,1551,31,67
아시아드대광로제비앙아파트,89257,821,3178,805,3178,16,133
아시아드대광로제비앙아파트,89258,3909,1383,3847,1383,62,176
아암3교사거리,38727,59,214,59,214,0,9
아암3교사거리,38728,122,120,116,120,6,8
아암물류단지,35285,147,2,114,2,33,4
아암물류단지,35590,22,170,4,170,18,6
아울렛(CGV부평),40818,3713,2403,3653,2403,60,203
아이즈빌(부평CGV),40595,11870,7955,11782,7955,88,660
아이즈빌(부평CGV),40598,9420,11665,9282,11665,138,702
아인스월드,55086,813,1500,809,1500,4,77
아주아파트,38047,1473,556,1438,556,35,67
아주아파트,38051,741,1288,729,1288,12,67
아주아파트,38301,1259,985,1246,985,13,74
아주아파트,38304,2412,1312,2405,1312,7,124
아주아파트.미추홀학교,39481,42060,17371,41511,17371,549,1981
아주아파트.미추홀학교,39482,20958,25226,20804,25226,154,1539
아주아파트410동,41575,649,5,649,5,0,21
아침가리마을회관,43287,122,3,108,3,14,4
아침가리마을회관,43867,0,66,0,66,0,2
아쿠아글로리,42811,111,3,106,3,5,3
아현역,22062,3788,31,3782,31,6,127
아현역,23078,14,2284,14,2284,0,76
안골마을입구,38225,9464,9678,9244,9678,220,638
안남고(동보1차아파트),41048,1111,1051,1096,1051,15,72
안남고등학교,41045,3870,985,3842,985,28,161
안동포교회,42700,455,101,384,101,71,18
안동포교회,42701,20,516,20,516,0,17
안동포사거리,42707,56,196,56,196,0,8
안동포사거리입구,42765,429,41,421,41,8,15
안동포사거리입구,42766,126,928,8,928,118,35
안산마을,43132,42,1,34,1,8,1
안산마을,43138,5,40,5,40,0,1
안산초등학교(구계산고교),41425,15543,12853,15451,12853,92,946
안양대학교,43177,802,453,793,453,9,41
안양대학교,43301,1056,370,1031,370,25,47
안풍산업삼거리,89312,88,7,76,7,12,3
안풍산업삼거리,89329,0,38,0,38,0,1
알앤디써비스,38477,116,1743,114,1743,2,61
알앤디써비스,38478,959,114,957,114,2,35
애관극장,35804,19,58,13,58,6,2
애보박물관,39667,8,36,8,36,0,1
애보박물관,39671,25,15,25,15,0,1
애전마을,43682,13,7,12,7,1,0
애전마을,43894,11,7,10,7,1,0
애전부락,90075,37,124,35,124,2,5
애전부락,90076,62,83,62,83,0,4
앰코코리아(블루오션골프클럽),39880,525,18,522,18,3,18
야곡,43236,83,16,83,16,0,3
야곡,43292,7,56,6,56,1,2
야촌,43210,7,5,7,5,0,0
야촌,43333,0,6,0,6,0,0
약대사거리,57006,3783,716,3781,716,2,149
약대사거리,57010,595,4229,595,4229,0,160
약대주민지원센터.약대초등학교,55080,1030,2069,1012,2069,18,103
약대주민지원센터.약대초등학교,55088,1959,637,1943,637,16,86
약암호텔,80071,436,102,432,102,4,17
약암호텔,80072,46,385,46,385,0,14
얀센백신,38519,138,0,137,0,1,4
얀센백신,38520,2,394,1,394,1,13
양갑리마을회관,90283,2,59,2,59,0,2
양갑리마을회관,90307,34,1,34,1,0,1
양갑리입구,90282,4,11,4,11,0,0
양갑리입구,90308,10,2,10,2,0,0
양곡도매시장,31037,2047,500,2044,500,3,84
양곡버스정류장,80115,180,563,179,563,1,24
양곡사거리.양촌터미널,80116,443,93,441,93,2,17
양골,43987,9,0,8,0,1,0
양골,43989,0,12,0,12,0,0
양구(오상1리),43262,16,79,16,79,0,3
양구(오상1리),43563,126,20,122,20,4,4
양달마을,43910,29,42,28,42,1,2
양달마을,43911,2,2,1,2,1,0
양도,43074,0,9,0,9,0,0
양도,43075,34,21,32,21,2,1
양도면사무소(나무),43912,473,382,459,382,14,28
양도면사무소(쉘터),43913,656,550,612,550,44,40
양도사거리.대림아파트.신안아파트,80076,710,41,708,41,2,25
양도사거리.삼용아파트,80077,100,624,100,624,0,24
양도초등학교,43329,239,202,221,202,18,14
양도초등학교,43568,157,185,154,185,3,11
양로원,40111,534,2504,534,2504,0,101
양로원,40113,2415,455,2415,455,0,95
양사면사무소,43501,21,36,19,36,2,1
양사면사무소,43658,30,31,30,31,0,2
양사우체국,43465,77,23,70,23,7,3
양사우체국,43736,20,43,20,43,0,2
양사초등학교,43466,104,26,100,26,4,4
양사초등학교,43734,13,47,12,47,1,2
양사파출소,43722,11,9,11,9,0,0
양수장,43592,150,2,147,2,3,5
양수장,43781,0,147,0,147,0,4
양오1리마을회관,43454,0,55,0,55,0,1
양오1리마을회관,43666,44,0,38,0,6,1
양오2리경로당,43453,1,60,1,60,0,2
양오2리경로당,43625,9,0,9,0,0,0
양오2리앞,90049,9,24,5,24,4,1
양오리저수지마을,90102,0,19,0,19,0,0
양오리저수지마을,90103,104,0,101,0,3,3
양오저수지입구,90100,0,4,0,4,0,0
양오저수지입구,90101,15,0,15,0,0,0
양왕마을,43927,14,0,14,0,0,0
양왕마을,43928,1,24,0,24,1,0
양재역,31073,15314,4547,15292,4547,22,662
양재역.서초문화예술회관,31008,2675,2597,2672,2597,3,175
양재역.서초문화예술회관,31010,1594,1914,1594,1914,0,116
양재역말죽거리.강남베드로병원,23318,289,135,289,135,0,14
양지공원,38133,5489,4153,5365,4153,124,321
양지촌,43163,19,8,19,8,0,0
양지촌,43342,14,19,13,19,1,1
양진말입구,90056,2,2,1,2,1,0
양진말입구,90057,1,79,1,79,0,2
양촌중학교,41629,725,922,705,922,20,54
양촌중학교,41630,343,491,342,491,1,27
양평해장국,44145,34,15,25,15,9,1
양평해장국,44178,3,15,3,15,0,0
어두,43206,0,11,0,11,0,0
어두,43280,6,0,6,0,0,0
어두마을,43155,130,8,126,8,4,4
어두마을,43322,13,80,13,80,0,3
어류정입구,90175,26,77,25,77,1,3
어류정입구,90176,19,10,19,10,0,0
어류정입구,90312,2,6,2,6,0,0
어류정항,90323,14,5,13,5,1,0
어류정항,90400,0,2,0,2,0,0
어린이집앞,43402,129,0,110,0,19,4
어린이집앞,43585,3,138,3,138,0,4
에덴하우스,42788,583,2064,575,2064,8,88
에몬스가구,39023,2049,3436,2043,3436,6,182
에몬스가구,39024,3572,1309,3569,1309,3,162
에스틸,89232,267,97,261,97,6,12
에이에프티,39110,835,2185,809,2185,26,100
에코메트로10단지,39728,506,239,503,239,3,24
에코메트로10단지,39736,123,389,123,389,0,17
에코메트로11단지,39652,2115,2506,2065,2506,50,154
에코메트로11단지후문,39701,607,1581,578,1581,29,72
에코메트로12단지,39651,3491,1696,3417,1696,74,172
에코메트로12단지,39653,54,577,50,577,4,21
에코메트로5단지·논현센트럴뷰,39779,702,1484,687,1484,15,72
에코메트로6단지,39716,3718,406,3620,406,98,137
에코메트로6단지,39758,72,2154,69,2154,3,74
에코메트로7단지,39714,9103,4522,8959,4522,144,454
에코메트로7단지,39715,4680,5841,4617,5841,63,350
에코메트로9단지,39750,7317,1123,7122,1123,195,281
에코메트로9단지,39752,2069,4485,2060,4485,9,218
에코메트로더타워,39711,128,587,109,587,19,23
에코크레이션,89449,49,0,49,0,0,1
에코크레이션,89450,0,46,0,46,0,1
엑스포빌리지10단지,38460,2904,1488,2832,1488,72,146
엑스포빌리지9단지,38482,2971,7259,2877,7259,94,341
엑슬루타워,37187,3490,8344,3397,8344,93,394
엑슬루타워,42836,3129,12745,2994,12745,135,529
엘리지안타운,42394,1833,1663,1776,1663,57,116
엘아이지식산업센터,39944,391,1197,382,1197,9,52
엘아이지식산업센터(맞은편),92029,949,216,945,216,4,38
엘지슈퍼,39457,1327,1965,1308,1965,19,109
엠파크타워,42025,3570,4517,3534,4517,36,269
엠파크타워,42026,5113,3659,5058,3659,55,292
여고입구,90232,479,458,447,458,32,31
여고입구,90233,807,551,792,551,15,45
여성의광장,38084,3216,4054,3174,4054,42,242
여성의광장,38085,4387,4300,4305,4300,82,289
여우고개,43980,27,151,27,151,0,5
여우고개,43981,89,89,89,89,0,5
여우별펜션,44142,7,19,7,19,0,0
여우별펜션,44179,22,3,19,3,3,0
여우재,35147,340,324,334,324,6,22
여의도역,19155,568,1,568,1,0,18
여의도역,19156,18,1131,18,1131,0,38
여의도환승센터,19007,8,398,8,398,0,13
여차리,43424,37,48,35,48,2,2
여차리,43472,47,24,46,24,1,2
여차리회관,43505,48,24,45,24,3,2
여차리회관,43525,29,14,26,14,3,1
역삼역.포스코타워역삼,23288,1182,1134,1182,1134,0,77
연락골,39662,2,40,2,40,0,1
연락골,39665,33,9,33,9,0,1
연리입구,43267,35,0,34,0,1,1
연리입구,43614,0,16,0,16,0,0
연미고개,43198,0,104,0,104,0,3
연미고개,43711,70,3,67,3,3,2
연미정,43193,182,0,154,0,28,6
연미정,43621,1,81,1,81,0,2
연성교회,37278,6506,5182,6321,5182,185,389
연세농장,39851,128,3,126,3,2,4
연세대,39725,2499,10631,2474,10631,25,437
연세대,39861,10019,1485,9990,1485,29,383
연세대송도캠퍼스입구,38489,10614,4878,10581,4878,33,516
연세대앞,22022,3,12,3,12,0,0
연세대학교앞,22058,3161,27,3152,27,9,106
연수1동행정복지센터,38248,197,369,195,369,2,18
연수1동행정복지센터,38251,1087,1052,1052,1052,35,71
연수1차아파트,38187,5181,2190,5063,2190,118,245
연수2차아파트,38195,1120,2012,1083,2012,37,104
연수3동행정복지센터,38262,1286,651,1229,651,57,64
연수경찰서,38111,2897,2472,2847,2472,50,178
연수고등학교,38104,613,2604,584,2604,29,107
연수구청,38089,9565,5294,9355,5294,210,495
연수구청,38093,4034,10476,3981,10476,53,483
연수구청입구,38095,4840,4265,4798,4265,42,303
연수꿈담도서관,38103,7791,5218,7718,5218,73,433
연수병원,38296,4579,2647,4451,2647,128,240
연수여자고등학교,38092,2548,3942,2465,3942,83,216
연수역,38506,1655,1961,1615,1961,40,120
연수역,38507,924,1403,919,1403,5,77
연수역북측입구,38572,1620,3161,1586,3161,34,159
연수역북측입구,38573,2345,2702,2308,2702,37,168
연수우체국,38280,7368,3683,7257,3683,111,368
연수우체국,38314,1771,960,1717,960,54,91
연수주공3차아파트,38188,3296,4603,3223,4603,73,263
연수중학교,38194,1909,1510,1854,1510,55,113
연수중학교,38196,838,1028,815,1028,23,62
연수초등학교,38290,11356,10334,11060,10334,296,723
연수초등학교,38293,4166,4348,4070,4348,96,283
연수한양1차아파트,38091,2394,4404,2381,4404,13,226
연안동행정복지센터,35063,187,10312,184,10312,3,349
연안부두(신선초등학교),35097,1312,2851,1199,2851,113,138
연안부두로삼거리,35754,3,1015,2,1015,1,33
연안부두바다쉼터,35049,1395,16,1355,16,40,47
연안부두어시장,35071,91,7604,86,7604,5,256
연안부두어시장,35072,9209,237,8987,237,222,314
연안아파트,35075,10421,2434,10118,2434,303,428
연안아파트,35076,2145,9103,2065,9103,80,374
연안여객터미널,35057,9335,106,9067,106,268,314
연안여객터미널,35061,85,6274,73,6274,12,211
연안여객터미널,90115,40,58,40,58,0,3
연안여객터미널,90116,25,111,20,111,5,4
연안여객터미널입구,35068,2848,68,2740,68,108,97
연안초등학교,35064,20601,333,19859,333,742,697
연안초등학교,35067,178,14330,163,14330,15,483
연지-기점,90256,2297,2232,2286,2232,11,150
연학초등학교,37137,7245,1816,7155,1816,90,302
연학초등학교,37138,1549,6836,1511,6836,38,279
연합의원,42186,4536,1883,4435,1883,101,213
연화중학교,38117,2765,3282,2734,3282,31,201
연흥아파트,37567,3560,4874,3497,4874,63,281
연흥아파트,37568,2801,6455,2718,6455,83,308
연희공원,42950,95,147,95,147,0,8
연희동광명아파트(사계절썰매장),42314,1819,1909,1786,1909,33,124
연희동광명아파트(사계절썰매장),42599,1628,2274,1572,2274,56,130
연희동행정복지센터,42311,851,1519,836,1519,15,79
연희동행정복지센터,42312,1834,1126,1786,1126,48,98
열우물보조경기장주차장,40916,179,98,126,98,53,9
열우물사거리,40052,17,240,16,240,1,8
열우물전통시장,40028,495,2444,483,2444,12,97
열우물전통시장,40030,2275,402,2237,402,38,89
열우물전통시장입구,40036,2197,428,2144,428,53,87
열우물전통시장입구,40038,329,3710,307,3710,22,134
열우물테니스경기장,40053,3827,3807,3795,3807,32,254
열우물테니스경기장,40054,999,1033,969,1033,30,67
열우물테니스경기장,40063,376,1132,372,1132,4,50
열우물테니스경기장,40064,259,651,255,651,4,30
열우물테니스경기장,42023,4853,4412,4794,4412,59,308
열우물테니스경기장,42024,3100,3010,3043,3010,57,203
영골,43954,2,2,2,2,0,0
영골,43955,0,12,0,12,0,0
영남1단지.고합아파트,70164,206,197,202,197,4,13
영남아파트,37060,5040,3939,4962,3939,78,299
영남아파트,37063,5706,4815,5539,4815,167,350
영남아파트,38203,2411,1512,2378,1512,33,130
영남아파트,38205,825,2515,811,2515,14,111
영림몰딩도어,39943,102,178,99,178,3,9
영림산업,39028,759,3416,759,3416,0,139
영림임업,39026,1089,3020,1086,3020,3,136
영사목장 앞,90390,0,18,0,18,0,0
영사목장 앞,90391,1,0,1,0,0,0
영선고등학교,40853,7,863,4,863,3,29
영은교회,43037,41,45,41,45,0,2
영은교회,43139,19,126,19,126,0,4
영은슈퍼,89052,28,1011,22,1011,6,34
영은슈퍼,89064,1025,9,971,9,54,34
영음교회.효성해링턴플레이스,41422,1886,2180,1877,2180,9,135
영종KCC스위첸.한양수자인,35449,431,1736,410,1736,21,72
영종KCC스위첸옆문,35755,719,7221,676,7221,43,264
영종KCC스위첸옆문,35756,7403,486,7333,486,70,262
영종LH2단지,35483,687,890,681,890,6,52
영종LH67단지,35872,830,803,812,803,18,54
영종LH67단지,35873,1405,663,1391,663,14,68
영종LH아파트입구,35390,77,75,77,75,0,5
영종e편한세상센텀베뉴·센트럴푸르지오자이,35660,4159,4098,4056,4098,103,275
영종고등학교,35493,2049,2397,1955,2397,94,148
영종고등학교,35496,1669,2075,1574,2075,95,124
영종공원묘지입구,35626,19,45,19,45,0,2
영종공원묘지입구,35627,16,4,16,4,0,0
영종교회,35306,260,332,247,332,13,19
영종교회,35545,1038,716,1010,716,28,58
영종국제병원,35881,290,785,277,785,13,35
영종대교휴게소,42942,3,130,3,130,0,4
영종대교휴게소,42943,128,20,128,20,0,4
영종동행정복지센터,35672,120,127,119,127,1,8
영종동행정복지센터,35673,71,46,69,46,2,3
영종물류고등학교·영종자이아파트,35314,4420,4602,4288,4602,132,300
영종물류고등학교앞·영종자이아파트,35307,6480,3780,6265,3780,215,342
영종버스공영차고지,35837,86,3,24,3,62,2
영종버스공영차고지,35838,149,87,14,87,135,7
영종블루오션,35819,141,116,137,116,4,8
영종블루오션,35820,39,140,32,140,7,5
영종블루오션2차,35876,1182,1497,1160,1497,22,89
영종블루오션2차,35877,1129,1741,1102,1741,27,95
영종선착장입구,35833,1956,1821,1909,1821,47,125
영종선착장입구,35834,12,258,12,258,0,9
영종성당.정도사,35850,6,46,6,46,0,1
영종성당.정도사,35851,11,8,11,8,0,0
영종센트럴푸르지오자이·e편한세상센텀베뉴,35661,4875,2913,4799,2913,76,259
영종소방서,35765,1,12,1,12,0,0
영종아레나,35830,141,2,122,2,19,4
영종아레나,35831,23,147,1,147,22,5
영종역,35566,48717,833,48256,833,461,1651
영종역,35567,2781,11158,2732,11158,49,464
영종역(2번출구),35870,17,1822,16,1822,1,61
영종역(청라행),35620,95,12168,83,12168,12,408
영종역사관,35624,225,88,222,88,3,10
영종역사관,35625,77,204,74,204,3,9
영종유승한내들스카이스테이,35759,3204,1046,3153,1046,51,141
영종유승한내들스카이스테이,35760,1053,1849,1035,1849,18,96
영종자이아파트,35835,36,142,36,142,0,5
영종자이아파트,35836,384,128,384,128,0,17
영종장로교회,35580,56,83,52,83,4,4
영종장로교회,35581,43,42,38,42,5,2
영종주공7단지,35111,1538,1324,1480,1324,58,95
영종주야간보호센터,35854,1,3,1,3,0,0
영종주야간보호센터,35855,16,4,16,4,0,0
영종중학교,35463,2259,2868,2042,2868,217,170
영종중학교,35464,5707,1530,5446,1530,261,241
영종진공원,35276,838,344,817,344,21,39
영종진공원,35279,135,1677,135,1677,0,60
영종풍림아이원1차,35110,5,222,4,222,1,7
영종하늘도서관,35585,1707,1304,1659,1304,48,100
영종하늘도서관,35586,1356,1588,1321,1588,35,98
영종힐스테이트(904동),35880,161,761,151,761,10,30
영진아파트,40551,165,449,165,449,0,20
영창한의원,40452,6906,5075,6826,5075,80,399
영풍아파트,36040,9929,3326,9737,3326,192,441
영풍아파트,39546,30,340,28,340,2,12
영흥대교입구,44100,0,2,0,2,0,0
영흥대교입구,44180,0,4,0,4,0,0
영흥면사무소,44131,0,4,0,4,0,0
영흥면사무소,44181,26,3,25,3,1,0
영흥버스터미널,44004,4890,4129,4601,4129,289,300
영흥버스터미널,44116,170,17,149,17,21,6
영흥빌라,44182,2,0,2,0,0,0
영흥수협공판장입구,44009,464,4,453,4,11,15
영흥수협공판장입구,44010,12,692,10,692,2,23
영흥어린이집,44137,6,23,5,23,1,0
영흥우체국,44107,20,27,17,27,3,1
영흥우체국,44183,28,22,28,22,0,1
영흥종합운동장앞,44120,1,26,1,26,0,0
영흥종합운동장앞,44192,22,1,22,1,0,0
영흥초교입구,44101,26,5,24,5,2,1
영흥초교입구,44184,2,5,2,5,0,0
영흥칼국수,44136,10,14,10,14,0,0
영흥플로레도커피,44144,11,10,10,10,1,0
영흥플로레도커피,44185,1,13,1,13,0,0
예단포,35319,176,292,174,292,2,15
예단포,35395,328,117,316,117,12,14
예단포물양장,35622,175,29,174,29,1,6
예단포물양장,35623,63,126,63,126,0,6
예드림빌라입구,35546,93,24,83,24,10,3
예드림빌라입구,35547,38,104,36,104,2,4
예림임업,39053,56,360,55,360,1,13
예림임업,39054,260,131,260,131,0,13
예비군교육장,41272,1012,1545,1005,1545,7,85
예비군교육장,41273,2143,3080,2130,3080,13,174
예비군교육장입구,90010,34,6,30,6,4,1
예비군교육장입구,90011,1,23,1,23,0,0
예비군훈련장,43201,195,12,193,12,2,6
예비군훈련장,43315,13,152,13,152,0,5
예송중학교,38592,1841,1430,1815,1430,26,109
예송중학교,38593,2318,1654,2212,1654,106,132
예술회관사거리,37254,3719,6460,3675,6460,44,339
예술회관역,39206,3501,10843,3459,10843,42,478
예술회관역(4번출구),39207,5577,5348,5503,5348,74,364
예원앞,41499,42,91,42,91,0,4
예원앞,41515,31,0,31,0,0,1
옐림교회,40854,5683,4969,5663,4969,20,355
옐림교회앞,35684,52,26,52,26,0,2
옐림교회앞,35694,30,42,29,42,1,2
오공본드,39108,4646,3258,4572,3258,74,263
오관물입구,35859,1,4,1,4,0,0
오관물입구,35860,14,0,14,0,0,0
오두돈대,43361,45,3,38,3,7,1
오두돈대,43536,3,29,3,29,0,1
오두리(넙성입구),43638,14,5,12,5,2,0
오두리(넙성입구),43675,2,50,2,50,0,1
오두리종점,43137,48,18,42,18,6,2
오두리종점,43529,26,64,26,64,0,3
오두마을입구,43557,27,0,27,0,0,0
오두마을입구,43647,1,26,1,26,0,0
오라니마을,80360,49,95,48,95,1,4
오류골,43013,227,91,223,91,4,10
오류골,43014,80,189,80,189,0,8
오류내,43389,25,372,22,372,3,13
오류내,43757,376,26,355,26,21,13
오류동마을,41353,1595,694,1571,694,24,76
오류동마을,41354,1083,3870,1052,3870,31,165
오류동역입구,89058,2,18,2,18,0,0
오류동역입구,89066,22,255,22,255,0,9
오리정,80125,1047,158,1030,158,17,40
오리정,80126,97,884,90,884,7,32
오상리고인들,43265,20,7,20,7,0,0
오상리고인들,43379,1,17,1,17,0,0
오상입구,43119,28,20,28,20,0,1
오상입구,43120,0,44,0,44,0,1
오상입구,43390,5,73,5,73,0,2
오상입구,43565,62,9,53,9,9,2
오성교회,43555,23,1,23,1,0,0
오성교회,43853,0,37,0,37,0,1
오성아파트,40480,5833,1817,5649,1817,184,255
오성아파트,40487,1866,4488,1824,4488,42,211
오성아파트,40493,453,2297,443,2297,10,91
오성아파트,40721,195,380,186,380,9,19
오성정밀,39490,587,814,583,814,4,46
오이도역,70031,797,6437,783,6437,14,241
오이도역,70032,6062,845,5983,845,79,230
오정휴먼시아(중),57044,395,1952,395,1952,0,78
오정휴먼시아(중),57045,2045,410,2019,410,26,81
오조산공원,41246,1789,1130,1761,1130,28,97
오조산공원,41249,3215,3081,2973,3081,242,209
오조산공원,41621,39,383,19,383,20,14
옥골.옥토끼우주센터,43033,133,195,133,195,0,10
옥골.옥토끼우주센터,43561,101,62,98,62,3,5
옥골사거리,38731,528,3287,511,3287,17,127
옥골사거리,38732,410,169,397,169,13,19
옥금말,43952,102,27,68,27,34,4
옥금말,43953,17,63,16,63,1,2
옥련1동행정복지센터,38217,8901,5526,8807,5526,94,480
옥련2동행정복지센터(옥련우체국),38450,2573,45,2516,45,57,87
옥련2동행정복지센터(옥련우체국),38451,1031,2304,1015,2304,16,111
옥련고개,38212,1569,3305,1549,3305,20,162
옥련고개,38219,1410,1169,1369,1169,41,85
옥련동성당,38330,819,2036,801,2036,18,95
옥련사거리,38170,840,1011,812,1011,28,61
옥련사거리,38171,1495,755,1423,755,72,75
옥련여고입구,38271,822,785,808,785,14,53
옥련여고입구,38273,840,2358,807,2358,33,106
옥련중학교,38470,7152,4535,6955,4535,197,389
옥련지구대,38223,1259,3878,1181,3878,78,171
옥련초등학교,38146,3717,4155,3566,4155,151,262
옥림교회,43202,26,0,25,0,1,0
옥림교회,43716,10,57,10,57,0,2
옥림슈퍼,43205,224,21,223,21,1,8
옥림슈퍼,43720,46,112,37,112,9,5
온누리병원,42425,307,1021,295,1021,12,44
온수교차로,90231,2,107,2,107,0,3
온수리,43018,5969,2074,5663,2074,306,268
온수리,43020,3447,5203,3250,5203,197,288
온수시장,43019,72,35,65,35,7,3
온수시장,43095,58,387,55,387,3,14
올리브백화점,39359,4186,1649,4132,1649,54,194
올리브백화점,39363,1842,2486,1794,2486,48,144
올리브백화점,39364,13649,14079,13439,14079,210,924
올리브백화점,39589,17233,17711,17041,17711,192,1164
올리브백화점,39746,15083,17874,14925,17874,158,1098
올리브백화점,39747,22187,25344,21987,25344,200,1584
올림픽공원,39209,2764,4122,2732,4122,32,229
올림픽공원,39210,344,617,339,617,5,32
올림픽생활기념관,39349,4733,5868,4698,5868,35,353
옹장골,43171,18,107,18,107,0,4
옹장골,43230,112,11,106,11,6,4
옹진군청,37019,1359,2337,1331,2337,28,123
옹진군청,37020,8710,1448,8567,1448,143,338
완정공단입구,42409,5540,3695,5342,3695,198,307
완정사거리,42561,23372,7685,23210,7685,162,1035
완정사거리,42562,251,1730,203,1730,48,66
완정역,42673,12402,30865,12226,30865,176,1442
완정역,42674,7193,18058,7093,18058,100,841
완정초등학교.검단도서관,42414,3591,6176,3487,6176,104,325
완정초등학교.검단도서관,42415,4346,5329,4069,5329,277,322
왕궁가든,41289,1957,2520,1919,2520,38,149
왕궁가든,41291,2443,3227,2379,3227,64,189
왕길고가,42551,1105,45,1025,45,80,38
왕길고가,42552,6,990,4,990,2,33
왕길동,42386,16,326,14,326,2,11
왕길동,42387,149,125,139,125,10,9
왕길동(기점),42699,928,19,832,19,96,31
왕길동종점,42594,320,383,7,383,313,23
왕길역,89199,23,14,22,14,1,1
왕길역,89200,21,47,13,47,8,2
왕리물,90098,0,5,0,5,0,0
왕리물,90099,1,1,1,1,0,0
왕산골,35490,43,33,39,33,4,2
왕산골,35491,26,53,25,53,1,2
왕산교,35632,36,53,36,53,0,2
왕산교,35633,2,40,2,40,0,1
왕산차고지,35403,610,124,591,124,19,24
왕산차고지,35720,104,11,96,11,8,3
왕산해수욕장(왕산요트경기장),35020,1253,207,1243,207,10,48
왕산해수욕장(왕산요트경기장),35021,214,1241,206,1241,8,48
외1리마을회관앞,44096,44,41,32,41,12,2
외1리마을회관앞,44186,30,0,27,0,3,1
외1리소장골,44133,28,69,23,69,5,3
외뜰,43687,8,12,8,12,0,0
외뜰,43745,5,32,5,32,0,1
외리보건지소앞,44095,17,44,15,44,2,2
외리보건지소앞,44187,4,0,3,0,1,0
외주,43181,69,10,69,10,0,2
외주,43241,9,93,9,93,0,3
외포1리,43283,12,98,12,98,0,3
외포고개,43244,64,133,64,133,0,6
외포고개,43366,5,150,3,150,2,5
외포리,43556,1643,1773,1536,1773,107,113
외포리(싱싱마트),90376,68,41,54,41,14,3
외포리(하나로마트),90387,3,161,3,161,0,5
외포리(하나로마트),90388,140,33,135,33,5,5
외포리소공원,90127,25,8,22,8,3,1
외포리소공원,90128,1,51,1,51,0,1
외포리정미소,43240,87,8,78,8,9,3
외포삼거리,43110,373,132,339,132,34,16
외포삼거리,43285,11,105,11,105,0,3
요곡,43655,130,126,117,126,13,8
요곡,43762,57,41,52,41,5,3
요골,43590,65,0,63,0,2,2
요골,43780,0,11,0,11,0,0
용갈비,40338,124,2834,119,2834,5,98
용구물길,90385,0,16,0,16,0,0
용구물길,90386,14,0,11,0,3,0
용궁사입구,35578,133,791,132,791,1,30
용궁사입구,35579,608,60,597,60,11,22
용남시장,37232,17775,14302,17412,14302,363,1069
용남시장,37236,17309,18220,16947,18220,362,1184
용남파출소,37177,7171,2113,7146,2113,25,309
용남파출소,37184,3652,10065,3620,10065,32,457
용담공원,38172,1297,1932,1282,1932,15,107
용담공원,38177,1901,1483,1846,1483,55,112
용담마을,38191,4744,4926,4640,4926,104,322
용담마을,38192,4353,2842,4272,2842,81,239
용담바다낚시터,44132,0,3,0,3,0,0
용담바다낚시터,44188,4,0,4,0,0,0
용담어촌계앞,44097,40,22,33,22,7,2
용담어촌계앞,44189,1,0,1,0,0,0
용당사터,43537,45,1,44,1,1,1
용당사터,43677,1,36,1,36,0,1
용유동행정복지센터,35017,117,42,117,42,0,5
용유동행정복지센터,35211,71,210,63,210,8,9
용유동행정복지센터,35411,132,257,132,257,0,12
용유동행정복지센터,35412,252,102,247,102,5,11
용유역,35433,121,1016,121,1016,0,37
용유초등학교,35022,286,28,273,28,13,10
용유초등학교,35023,55,338,53,338,2,13
용유초등학교,35409,35,468,35,468,0,16
용유초등학교삼거리,35410,366,46,366,46,0,13
용일사거리,37208,28463,22300,28290,22300,173,1692
용일사거리,37218,27222,26752,26891,26752,331,1799
용일사거리,37251,1236,1350,1193,1350,43,86
용일초등학교,37233,12306,8309,12144,8309,162,687
용일초등학교,37237,7908,15828,7713,15828,195,791
용정리 사거리,43721,1,211,1,211,0,7
용정마을회관,43370,1,62,1,62,0,2
용정마을회관,43615,316,0,278,0,38,10
용정초등학교,37297,1523,656,1503,656,20,72
용정초등학교,37299,595,2419,586,2419,9,100
용진주택,43084,274,45,265,45,9,10
용진주택,43085,11,17,11,17,0,0
용진진,43639,1,25,1,25,0,0
용진진,43678,25,5,25,5,0,1
용현2동행정복지센터,37653,1433,138,1404,138,29,52
용현2동행정복지센터,37654,409,1603,274,1603,135,67
용현3동행정복지센터.보훈병원,37221,22094,16647,21588,16647,506,1291
용현3동행정복지센터.보훈병원,37224,12124,12685,11905,12685,219,826
용현5동행정복지센터,37129,232,758,232,758,0,33
용현고가교,37550,109,1913,105,1913,4,67
용현고가교,37611,11073,1667,11072,1667,1,424
용현고개,37178,3538,3800,3438,3800,100,244
용현고개,37497,4075,5139,4014,5139,61,307
용현동농협,37117,500,3134,489,3134,11,121
용현동상우빌라,37564,8,761,8,761,0,25
용현동상우빌라,37565,1815,96,1707,96,108,63
용현동성원상떼빌아파트,37546,461,518,435,518,26,32
용현사거리,37212,1353,1325,1316,1325,37,89
용현사거리,37213,1385,3982,1315,3982,70,178
용현시장,37227,23967,28523,23396,28523,571,1749
용현시장,37230,25865,15250,25383,15250,482,1370
용현시장,37268,5739,3686,5556,3686,183,314
용현시장,37270,4891,5885,4716,5885,175,359
용현아파트,37153,47,333,45,333,2,12
용현중학교,37021,3241,637,3187,637,54,129
용현중학교,37028,1098,2787,1046,2787,52,129
용현초등학교,37508,1,731,1,731,0,24
용현초등학교입구,37128,10873,3581,10642,3581,231,481
용현초등학교입구,37134,6944,12430,6771,12430,173,645
용화사(길상낚시터),90077,28,42,28,42,0,2
용화사(길상낚시터),90080,54,52,54,52,0,3
우뢰촌,43425,157,81,147,81,10,7
우뢰촌,43792,117,46,103,46,14,5
우리자동차,35223,1030,263,770,263,260,43
우림라이온스밸리,40592,406,4810,401,4810,5,173
우림라이온스밸리,40594,9232,1377,9183,1377,49,353
우림필유아파트,42924,3258,1537,3188,1537,70,159
우림필유아파트,42925,1340,2686,1317,2686,23,134
우물골,43929,35,6,31,6,4,1
우물골,43930,0,4,0,4,0,0
우미린1단지정문,35583,2771,835,2745,835,26,120
우미린1단지정문,35584,1163,2853,1152,2853,11,133
우미린1단지후문,35461,1222,4120,1194,4120,28,178
우미린1단지후문,35462,4483,746,4450,746,33,174
우미린2단지정문,35512,3874,1549,3795,1549,79,180
우미린2단지정문,35513,2568,4872,2512,4872,56,248
우미린2단지후문,35454,3003,1619,2886,1619,117,154
우미린더시그니처(후문),89443,3439,321,3439,321,0,125
우성1차아파트,38094,4045,4296,3942,4296,103,278
우성1차아파트,39834,352,36,340,36,12,12
우성2차아파트(옥련동),38356,2507,725,2475,725,32,107
우성2차아파트·원인재역(4번출구),38150,2870,6221,2825,6221,45,303
우성4차,40185,7818,220,7727,220,91,267
우성4차,40187,199,7016,196,7016,3,240
우성4차후문,40730,132,3058,126,3058,6,106
우성4차후문,40731,3677,216,3639,216,38,129
우성아파트,38143,4262,1878,4205,1878,57,204
우성아파트,38357,1260,2286,1220,2286,40,118
우성아파트,40341,774,1066,772,1066,2,61
우성아파트,42717,2815,4786,2809,4786,6,253
우성아파트,42718,1638,1931,1631,1931,7,118
우성아파트.은행교회,70026,523,43,508,43,15,18
우저서원(대성주유소),35214,160,108,158,108,2,8
우저서원(대성주유소),35215,65,601,57,601,8,22
우주골드타운빌라,40863,769,1206,763,1206,6,65
우주골드타운빌라,40864,361,1182,358,1182,3,51
우주아파트,38252,7103,8878,6984,8878,119,532
우진기계,89106,16,184,16,184,0,6
우진아파트,37158,1886,2124,1808,2124,78,133
우진아파트,37159,396,2751,372,2751,24,104
우체국사거리,39694,798,1529,798,1529,0,77
우체국사거리,39695,1782,742,1696,742,86,84
우체국사거리,39704,2356,3690,2285,3690,71,201
욱일아파트후문,40877,1583,2233,1567,2233,16,127
운남교차로,35435,57,130,42,130,15,6
운남교차로,35444,109,82,107,82,2,6
운남교차로,35524,64,33,62,33,2,3
운남교차로,35582,39,54,36,54,3,3
운남교차로 입구,35839,17,36,17,36,0,1
운남교차로 입구,35840,35,35,35,35,0,2
운남교차로.잔다리,35595,439,220,432,220,7,21
운남교차로.잔다리,35596,152,548,150,548,2,23
운남동,35268,101,220,98,220,3,10
운남동,35281,219,321,218,321,1,18
운남동우체국,35848,270,146,263,146,7,13
운남동우체국,35849,160,337,150,337,10,16
운남초교사거리,35706,27,137,27,137,0,5
운남초교사거리,35707,431,201,431,201,0,21
운북공영차고지,35779,442,15,424,15,18,15
운북공영차고지,35783,0,337,0,337,0,11
운서2차SKVIEW스카이시티,35882,142,77,141,77,1,7
운서2차SKVIEW스카이시티,35883,6,221,6,221,0,7
운서SKVIEW 스카이시티,35780,10,0,10,0,0,0
운서SKVIEW·세계로향하는교회,35781,0,15,0,15,0,0
운서역,35242,23332,14512,22986,14512,346,1261
운서역,35257,8129,15510,7941,15510,188,787
운서역(남동측),35775,10,42,9,42,1,1
운서역(남동측),35776,28,52,28,52,0,2
운서역(하워드존슨호텔),35747,2987,4308,2967,4308,20,243
운서역금강펜테리움아파트,35482,702,471,702,471,0,39
운서역반도유보라,35878,1625,1888,1598,1888,27,117
운서역반도유보라,35879,799,1289,783,1289,16,69
운서초등학교,35270,5914,2046,5829,2046,85,265
운서초등학교,35282,2311,3484,2191,3484,120,193
운양역,80348,217,256,217,256,0,15
운양역,80351,272,98,264,98,8,12
운연동,39374,582,720,559,720,23,43
운연동,39379,708,556,692,556,16,42
운연동,39673,54,0,53,0,1,1
운연삼거리,39987,480,1626,457,1626,23,70
운연삼거리,39988,86,571,86,571,0,21
운연역,39954,10986,11106,10931,11106,55,736
운연역,92026,6531,7252,6484,7252,47,459
운연천,92027,266,829,260,829,6,36
운연천,92028,400,172,395,172,5,19
운전면허시험장,39005,2454,802,2439,802,15,108
울레기,43179,10,246,10,246,0,8
울레기,43548,256,11,228,11,28,8
웃말,90169,1,35,1,35,0,1
웃말,90170,40,5,38,5,2,1
원당고등학교,42459,2977,3263,2953,3263,24,208
원당사거리.검단선사박물관,42446,18868,7251,18625,7251,243,870
원당사거리.검단선사박물관,42447,10853,18226,10687,18226,166,969
원당중고등학교,42460,78,207,78,207,0,9
원당중고등학교,42462,170,268,170,268,0,14
원동초등학교,39656,1699,7254,1572,7254,127,298
원동초등학교,39657,10277,1930,10079,1930,198,406
원성골,35434,44,176,38,176,6,7
원성골,35445,78,293,77,293,1,12
원수리마을,90251,1,7,1,7,0,0
원수리마을,90252,4,2,4,2,0,0
원인재역(1번출구),38162,1919,6798,1904,6798,15,290
원인재역(4번출구),38153,9787,2753,9747,2753,40,418
원인재역(6번출구),38166,6335,2399,6300,2399,35,291
원적산터널,40821,1490,3594,1450,3594,40,169
원적산터널,40822,2452,3029,2419,3029,33,182
원적산터널서측,42666,5656,4208,5470,4208,186,328
원적산터널서측,42667,3954,4104,3916,4104,38,268
원종IC(중),57046,38,3029,38,3029,0,102
원종IC(중),57047,861,102,851,102,10,32
원진운수차고지,89003,672,7,661,7,11,22
원진운수차고지,89004,63,833,5,833,58,29
원창동(기점),89143,2813,22,2689,22,124,94
원창동(기점),89144,92,2330,6,2330,86,80
원창동(종점),42183,14,975,4,975,10,32
원창동(종점),42184,528,18,468,18,60,18
원흥아파트,38131,23794,15299,23393,15299,401,1303
원흥아파트,38336,32461,22259,31879,22259,582,1824
원흥아파트,42793,89,11,89,11,0,3
월곳삼거리,43188,0,55,0,55,0,1
월곳삼거리,43619,116,0,112,0,4,3
월곶,70002,182,6,90,6,92,6
월곶동주민센터.월곶포구,70006,886,169,874,169,12,35
월곶동주민센터.월곶포구,70005,247,1289,237,1289,10,51
월곶풍림아파트3차,70030,91,66,87,66,4,5
월드메르디앙아파트,42161,4164,5006,4012,5006,152,305
월드메르디앙아파트,42163,6355,3551,6226,3551,129,330
월드아파트,42499,7995,9368,7898,9368,97,578
월드아파트,42500,11235,6267,11190,6267,45,583
월미공원,35138,95,1047,93,1047,2,38
월미공원,35572,235,37,222,37,13,9
월미공원역,35345,230,4812,219,4812,11,168
월미공원역,35346,6944,287,6878,287,66,241
월미도,35148,41643,329,40422,329,1221,1399
월미도(시티투어),35144,1170,18384,1109,18384,61,651
월미도문화관,35558,2122,52,2054,52,68,72
월미도종점,35368,312,8564,166,8564,146,295
월미문화의거리,35132,39,4471,33,4471,6,150
월미문화의거리,35219,2663,56,2591,56,72,90
월미테마파크,35128,132,14848,131,14848,1,499
월미테마파크,35502,8072,90,7826,90,246,272
월선포,90040,75,86,68,86,7,5
월선포,90041,43,2,40,2,3,1
웨딩타운,22061,178,3,178,3,0,6
웨딩타운,23077,1,30,1,30,0,1
웰카운티,38352,1291,5788,1274,5788,17,235
웰카운티,38353,11842,1449,11681,1449,161,443
웰카운티,42772,1583,3865,1488,3865,95,181
웰카운티17단지,89182,3012,854,2963,854,49,128
웰카운티17단지,89183,684,2393,663,2393,21,102
웰카운티1단지,38648,856,2273,839,2273,17,104
웰카운티1차,42746,1856,1180,1856,1180,0,101
웰카운티1차,42764,1846,1162,1825,1162,21,100
웰카운티2단지,38709,589,819,569,819,20,46
웰카운티4단지,38446,793,179,763,179,30,32
웰카운티4단지,38447,171,1496,171,1496,0,55
윗말,43488,5,2,4,2,1,0
윗말,43839,3,3,3,3,0,0
윗망월,43335,0,81,0,81,0,2
윗망월,43578,133,0,126,0,7,4
유니온프라자,42113,12388,8041,12256,8041,132,680
유림골프장,41469,809,1,802,1,7,27
유성아파트,43086,127,764,127,764,0,29
유성아파트,43087,653,61,645,61,8,23
유수지,39010,571,749,561,749,10,44
유수지,39011,674,2092,672,2092,2,92
유수지근린공원,39019,982,869,979,869,3,61
유수지근린공원,39020,659,741,656,741,3,46
유수지길,39003,1023,2044,1020,2044,3,102
유수지길,39004,1386,1002,1378,1002,8,79
유승아파트,42397,2365,467,2322,467,43,94
유승아파트,42398,307,2061,290,2061,17,78
유승아파트(삼성홈타운아파트),41003,4071,3143,4039,3143,32,240
유승아파트(삼성홈타운아파트),41004,3534,3514,3449,3514,85,234
유승아파트(삼성홈타운아파트),41005,6558,2174,6460,2174,98,291
유승아파트(삼성홈타운아파트),41006,1725,6370,1702,6370,23,269
유승아파트(삼성홈타운아파트),41583,1,325,1,325,0,10
유원아파트,37163,6426,9795,6240,9795,186,540
유원아파트,37172,13114,5305,12892,5305,222,613
유진시스템앞,40676,1136,4417,1111,4417,25,185
유진시스템앞,40678,2051,1251,2012,1251,39,110
유진투자증권.파이낸셜뉴스신문,19283,785,7,785,7,0,26
유천아파트,38254,870,737,841,737,29,53
유천아파트,38266,7102,4894,7057,4894,45,399
유천아파트후문,38265,199,757,195,757,4,31
유현마을.신동아아파트,80001,143,213,143,213,0,11
유현마을.신동아아파트,80073,335,20,335,20,0,11
유현사거리,42484,6187,9718,6152,9718,35,530
유현사거리,42487,9141,4417,9088,4417,53,451
유호엔시티.논현푸르지오,39823,96,2106,81,2106,15,73
육골,18805,2,90,2,90,0,3
육골,62030,5,4,1,4,4,0
윤성아파트,38307,216,1727,213,1727,3,64
윤성아파트(인항고교),37011,5720,4896,5579,4896,141,353
윤성아파트(인항고교),37012,4249,2356,4165,2356,84,220
율도근린공원,89339,263,103,256,103,7,12
율도근린공원,89340,705,1136,699,1136,6,61
율도근린공원입구,89428,333,104,324,104,9,14
율도근린공원입구,89429,146,202,146,202,0,11
율도입구,42188,1403,1209,1372,1209,31,87
율도입구,42190,907,1021,900,1021,7,64
율목동행정복지센터,35787,33,110,32,110,1,4
율목동행정복지센터,35801,154,19,141,19,13,5
율목오거리,35786,55,38,45,38,10,3
율목오거리,35802,60,22,56,22,4,2
율생리입구,80016,188,945,184,945,4,37
율생리입구,80017,1111,199,1029,199,82,43
은계초등학교.사랑스러운교회,70025,1619,18,1578,18,41,54
은골공원,35599,1622,2143,1598,2143,24,125
은골공원,35600,1859,1812,1746,1812,113,122
은골사거리,35309,268,287,247,287,21,18
은당골,90212,22,17,21,17,1,1
은당골,90213,21,25,21,25,0,1
은봉초등학교,39613,11305,3000,11080,3000,225,476
은봉초등학교,39614,3053,13005,2984,13005,69,535
은성아파트,39321,7813,3723,7649,3723,164,384
은성프레미오,39325,1921,5188,1862,5188,59,236
은영빌라,41089,1884,149,1864,149,20,67
은영아파트,42218,4220,3991,4068,3991,152,273
은지초등학교사거리,42365,4411,5376,4337,5376,74,326
은하마을.중흥마을,55069,474,1464,460,1464,14,64
은하목장앞,43274,2,2,2,2,0,0
은하목장앞,43852,0,13,0,13,0,0
은하쌍용아파트,55062,1401,5751,1376,5751,25,238
은행마을,41198,8748,2966,8579,2966,169,390
은행초등학교,70019,3015,148,2914,148,101,105
을왕리해수욕장,35009,6687,653,6640,653,47,244
을왕리해수욕장,35010,683,8283,674,8283,9,298
을왕리해수욕장.더위크앤리조트,35015,2988,489,2964,489,24,115
을왕리해수욕장.더위크앤리조트,35016,444,2872,432,2872,12,110
읍내리마을회관입구,90032,0,39,0,39,0,1
읍내리마을회관입구,90033,70,1,58,1,12,2
응곡,43696,54,34,52,34,2,2
응곡,43749,38,51,31,51,7,2
이강리방앗간,43691,93,4,88,4,5,3
이강리방앗간,43832,16,197,13,197,3,7
이건창생가,43145,43,2,43,2,0,1
이건창생가,43434,1,53,1,53,0,1
이규보묘입구,90065,63,63,50,63,13,4
이규보묘입구,90389,61,70,59,70,2,4
이대역,22015,5392,71,5388,71,4,182
이대역,22057,3314,49,3313,49,1,112
이대역,23036,48,6444,48,6444,0,216
이마트,41122,5367,17938,5247,17938,120,776
이마트,41125,25508,9956,25276,9956,232,1182
이마트송림점,36098,5330,8108,5245,8108,85,447
이마트송림점,36100,8244,5424,8149,5424,95,455
이안송도,38409,20724,5900,20495,5900,229,887
이영화학,39644,2498,853,2498,853,0,111
이음5로.금호어울림센트럴,89433,287,1638,284,1638,3,64
이음5로.우미린더시그니처,89432,1115,460,1109,460,6,52
이음대로.대성베르힐,89440,2388,235,2363,235,25,87
이음대로.대성베르힐,89441,391,4690,380,4690,11,169
이음대로.디에트르더펠리체,89438,6563,934,6535,934,28,249
이음대로.호반써밋,89439,1588,5015,1551,5015,37,220
이촌,43312,0,10,0,10,0,0
이촌,43768,4,1,4,1,0,0
이토상가,39196,8202,1992,8075,1992,127,339
이현(이강리교회),43661,10,120,8,120,2,4
이현(이강리교회),43690,160,7,141,7,19,5
이화1동입구,41487,154,133,152,133,2,9
이화1동입구,41506,29,0,28,0,1,0
이화2동마을회관,41484,14,13,14,13,0,0
이화2동마을회관,41504,85,50,84,50,1,4
이화2동회차지,41486,26,21,26,21,0,1
이화교회앞,41489,13,24,13,24,0,1
이화동노인정,41490,172,87,165,87,7,8
이화동다리,41479,59,226,54,226,5,9
이화동다리,41516,307,14,305,14,2,10
이화진등마을경로당,41601,50,47,46,47,4,3
인고앞,37318,3880,6597,3788,6597,92,349
인고앞,37338,7088,4617,6954,4617,134,390
인고체육관,37305,10597,5559,10498,5559,99,538
인고체육관(동양장사거리),37309,8921,8514,8836,8514,85,581
인내마을,90181,14,20,14,20,0,1
인내마을,90182,18,8,18,8,0,0
인명여자고등학교,37199,31699,6802,31390,6802,309,1283
인명여자고등학교,37205,9178,42931,9047,42931,131,1736
인사리군부대앞,90268,6,15,6,15,0,0
인사리군부대앞,90270,3,0,3,0,0,0
인사리마을회관,90267,7,32,7,32,0,1
인사리마을회관,90271,4,5,4,5,0,0
인사리우무렛골,90266,7,52,6,52,1,1
인사리인현경로당앞,90269,23,21,23,21,0,1
인사리지석교회,90272,2,3,2,3,0,0
인산저수지,43354,68,66,65,66,3,4
인산저수지,43575,45,77,40,77,5,4
인삼농협앞,80305,31,270,30,270,1,10
인삼농협앞,80306,454,25,434,25,20,15
인성여자고등학교,35793,163,1002,136,1002,27,38
인성여자고등학교,35808,25,461,24,461,1,16
인송빌라,40241,2818,34,2766,34,52,95
인수초등학교,39386,11077,10023,11001,10023,76,703
인수초등학교,39392,14388,12529,14336,12529,52,897
인썸호텔,44134,61,44,52,44,9,3
인아교회,35091,1024,114,940,114,84,37
인아교회,35094,236,951,222,951,14,39
인재개발원,42281,1307,2202,1276,2202,31,116
인재개발원,42282,2294,1494,2242,1494,52,126
인제고등학교,39548,377,1364,361,1364,16,58
인천가정법원.인천지방법원등기국,37405,9455,12307,9265,12307,190,725
인천가정법원.인천지방법원등기국,37409,21697,20885,21524,20885,173,1419
인천가족공원입구,39493,1520,1309,1491,1309,29,94
인천가족공원입구,39495,1690,2715,1664,2715,26,146
인천가족공원입구,92059,2895,1886,2842,1886,53,159
인천가톨릭대학교,39931,4069,1516,4008,1516,61,186
인천경로당앞,90226,6,41,6,41,0,1
인천경로당앞,90227,10,9,10,9,0,0
인천경연초중학교,89347,18,209,18,209,0,7
인천공항T1(1층13B),35205,18421,269,18159,269,262,623
인천공항T1(1층2A),35344,39335,3242,38978,3242,357,1419
인천공항T1(1층2B),35202,12530,6191,12507,6191,23,624
인천공항T1(3층13번),35556,1332,12351,1250,12351,82,456
인천공항T1(3층14번),35753,1142,5113,1080,5113,62,208
인천공항T1(3층2번),35032,3702,40040,3684,40040,18,1458
인천공항T1(3층6번),35752,4460,11349,4409,11349,51,526
인천공항T1(3층7번),35203,11786,40919,11720,40919,66,1756
인천공항T1-3층,35325,6,12,6,12,0,0
인천공항T2(1)A(1층),35618,18526,28,18464,28,62,618
인천공항T2(1)번출입구(3층),35614,2534,21405,2522,21405,12,797
인천공항T2(6)B(1층),35619,7197,479,7148,479,49,255
인천공항T2(8)번출입구(3층),35615,644,6399,611,6399,33,234
인천공항T2-3층,35611,15,3,15,3,0,0
인천공항T2-B1층,35612,7,1,7,1,0,0
인천공항전망대,35365,2,55,2,55,0,1
인천공항전망대,35366,35,3,32,3,3,1
인천공항전망대(미정차),35630,6,0,6,0,0,0
인천공항충전소입구,35757,3,22,3,22,0,0
인천공항충전소입구,35758,25,0,19,0,6,0
인천과학예술영재학교,38579,164,74,161,74,3,7
인천과학예술영재학교,38580,49,639,45,639,4,22
인천광역시종합건설본부,37325,7912,6617,7832,6617,80,484
인천교(인천기계산업단지),37449,2223,1026,2197,1026,26,108
인천교(인천기계산업단지),37451,509,1609,487,1609,22,70
인천교삼거리,37453,3305,5245,3204,5245,101,285
인천교삼거리(인천기계산업단지),37452,2660,1872,2624,1872,36,151
인천교통공사,40032,40617,35120,40126,35120,491,2524
인천교회,38676,1969,4953,1930,4953,39,230
인천교회,39260,3509,3985,3450,3985,59,249
인천교회,39261,3828,2562,3781,2562,47,213
인천국민안전체험관,42233,6,102,6,102,0,3
인천국민안전체험관,42234,35,275,26,275,9,10
인천국제공항,35613,10,0,10,0,0,0
인천국제수산물타운,35815,16,1458,16,1458,0,49
인천국제수산물타운,35816,608,76,581,76,27,22
인천글로벌캠퍼스,39850,2277,2806,2232,2806,45,169
인천글로벌캠퍼스,39858,2713,1732,2672,1732,41,148
인천기계공고,37272,19337,7430,19274,7430,63,892
인천기계공고,37281,4404,12741,4404,12741,0,571
인천기계산업단지,37579,855,32,853,32,2,29
인천기계산업단지,37580,15,822,15,822,0,27
인천기독병원,35785,266,332,238,332,28,19
인천기독병원,35803,64,133,51,133,13,6
인천나비공원,40849,4577,61,4466,61,111,154
인천남동우체국,39630,7404,7623,7333,7623,71,500
인천남부초.힐스테이트푸르지오,37275,10386,14301,10131,14301,255,822
인천논현역앞,39658,12065,16053,11928,16053,137,937
인천논현역앞,39659,15176,9644,15028,9644,148,827
인천논현중학교,92060,105,1313,100,1313,5,47
인천논현중학교,92061,225,150,196,150,29,12
인천논현중학교,92062,648,105,635,105,13,25
인천대검도수련원,43456,0,90,0,90,0,3
인천대검도수련원,43695,84,0,84,0,0,2
인천대공원,39471,6703,1142,6622,1142,81,261
인천대공원,39478,5286,9867,5180,9867,106,505
인천대공원역,39395,8561,2505,8509,2505,52,368
인천대공원역,39398,81,3281,81,3281,0,112
인천대공원후문(장수동),39442,5526,1009,5446,1009,80,217
인천대입구역,38395,62797,17901,62685,17901,112,2689
인천대입구역,38396,15664,65567,15491,65567,173,2707
인천대입구역.롯데몰,38646,3548,730,3548,730,0,142
인천대입구역.롯데몰,38649,44,1723,44,1723,0,58
인천대정문,38385,28836,787,28771,787,65,987
인천대정문,38386,975,26175,963,26175,12,905
인천대학교공과대학,38376,294,12460,287,12460,7,425
인천대학교공과대학,38377,35633,57,35555,57,78,1189
인천대학교공과대학,38499,1220,20519,1049,20519,171,724
인천대학교북문,38750,199,61,199,61,0,8
인천대학교송도캠퍼스,38749,12734,5186,12714,5186,20,597
인천대학교자연과학대학,38375,204,15158,200,15158,4,512
인천대학교자연과학대학,38378,21070,223,21004,223,66,709
인천마전도서관,42556,13,701,10,701,3,23
인천만수고등학교,39680,2517,2082,2502,2082,15,153
인천만수고등학교,39681,1858,2357,1845,2357,13,140
인천미래생활고등학교,40470,4226,4827,4226,4827,0,301
인천미래생활고등학교,40474,6367,5564,6367,5564,0,397
인천미래생활고등학교,40483,911,2320,882,2320,29,107
인천미래생활고등학교,55032,3146,1403,3095,1403,51,151
인천박문초등학교,38608,325,158,319,158,6,16
인천박문초등학교,38609,140,375,134,375,6,17
인천보건고등학교,42144,3442,4662,3357,4662,85,270
인천보건고등학교,42146,6137,4477,5960,4477,177,353
인천부흥고등학교,40279,1358,554,1358,554,0,63
인천북항관공선부두,89195,17,763,17,763,0,26
인천북항관공선부두,89196,574,20,574,20,0,19
인천북항부두운영시설,42953,5,380,5,380,0,12
인천북항부두운영시설,42959,575,19,567,19,8,19
인천뷰티예술고등학교,38052,3491,4057,3406,4057,85,251
인천뷰티예술고등학교,38053,7380,3979,7319,3979,61,378
인천비즈니스고등학교,37421,4355,4134,4231,4134,124,282
인천비즈니스고등학교,37423,5193,4084,5138,4084,55,309
인천비즈니스고등학교,37614,8260,3736,8207,3736,53,399
인천비지니스고등학교,37615,580,3771,580,3771,0,145
인천상공회의소,92041,82,0,82,0,0,2
인천서곶초등학교,89355,526,2,508,2,18,17
인천서곶초등학교,89358,4,994,2,994,2,33
인천서부교육지원청,42336,1006,649,1004,649,2,55
인천서부교육지원청,42337,550,1616,538,1616,12,72
인천서부여성회관,42131,2206,1558,2137,1558,69,125
인천서부여성회관,42134,4233,5207,4117,5207,116,314
인천서창동우체국,39820,4876,9256,4838,9256,38,471
인천서창동우체국,39821,10008,2314,9952,2314,56,410
인천서창중학교,39767,5364,3585,5270,3585,94,298
인천서창중학교,39875,4441,2435,4345,2435,96,229
인천성모병원정문,40844,9187,9463,9029,9463,158,621
인천성모병원정문,40857,9638,7364,9529,7364,109,566
인천성모병원종점지주차장,40919,203,4194,188,4194,15,146
인천성모병원후문,40138,1981,7399,1935,7399,46,312
인천성모병원후문,40139,4676,1905,4606,1905,70,219
인천세무서,36169,4,26,4,26,0,1
인천세무서후문,36179,39,174,39,174,0,7
인천소방본부,37189,3703,7995,3578,7995,125,389
인천소방본부,37191,8584,4397,8309,4397,275,432
인천소방항공대,35809,118,12,111,12,7,4
인천소방항공대,35810,10,267,6,267,4,9
인천송도꿈유치원,38622,7053,22,7040,22,13,235
인천송도꿈유치원,38623,136,9250,108,9250,28,312
인천송일초등학교,38558,601,1340,588,1340,13,64
인천송일초등학교,38575,1061,1135,1034,1135,27,73
인천수산물센터,35069,6457,7171,6127,7171,330,454
인천스타트업파크,38390,1856,729,1828,729,28,86
인천스타트업파크,38394,775,2514,759,2514,16,109
인천시교육청 교육연수원,35782,0,5,0,5,0,0
인천시청후문,39290,13260,8934,13150,8934,110,739
인천시청후문,39292,11288,12585,11124,12585,164,795
인천아시아드주경기장(동문),89354,1229,7,920,7,309,41
인천아시아드주경기장(동문),89359,146,1194,115,1194,31,44
인천아시아드테니스장,89356,609,20,559,20,50,20
인천아시아드테니스장,89357,22,913,9,913,13,31
인천여객터미널,89155,3,259,3,259,0,8
인천여자고등학교,38287,9373,8611,9315,8611,58,599
인천여자고등학교,38289,4981,6070,4857,6070,124,368
인천여자상업고등학교,35139,349,2589,326,2589,23,97
인천여자상업고등학교·이마트,35141,9305,3094,9163,3094,142,413
인천역(차이나타운),35178,39694,25595,38994,25595,700,2176
인천역(차이나타운),35179,28981,35062,28610,35062,371,2134
인천연세병원,42310,2616,2613,2579,2613,37,174
인천연합의원,42601,2466,4166,2412,4166,54,221
인천영어마을,42454,6337,3968,6312,3968,25,343
인천영어마을,42697,5210,10151,5114,10151,96,512
인천영어마을.파라곤센트럴,89437,3184,438,3177,438,7,120
인천영어마을앞,89436,62,176,61,176,1,7
인천예림학교(인천성모병원),40819,5204,5959,5138,5959,66,372
인천예림학교(인천성모병원),40820,6905,4280,6764,4280,141,372
인천예술고등학교,39332,936,547,923,547,13,49
인천예술고등학교,39533,465,655,455,655,10,37
인천옹진농협본점,35555,7190,4767,6861,4767,329,398
인천옹진농협본점,35797,899,1792,855,1792,44,89
인천의료원,36093,613,4490,602,4490,11,170
인천의료원,36107,15010,8819,14862,8819,148,794
인천의료원,36108,9090,12405,8974,12405,116,716
인천의료원,37458,5052,732,5047,732,5,192
인천이음중학교,89456,2971,851,2951,851,20,127
인천이음중학교,89465,9,22,9,22,0,1
인천이음초등학교,89399,3065,512,3065,512,0,119
인천이음초등학교,89400,2051,9635,2025,9635,26,389
인천인력개발원,39071,1464,812,1464,812,0,75
인천인력개발원,39072,680,2061,669,2061,11,91
인천재능대정문,36172,17,4,17,4,0,0
인천재능대정문,36175,4,8,4,8,0,0
인천재능대후문,36173,1,4,1,4,0,0
인천재능대후문,36174,41,1,41,1,0,1
인천적십자병원(풍림아파트),38240,3788,5156,3680,5156,108,298
인천적십자병원(풍림아파트),38339,5838,4631,5695,4631,143,348
인천정보과학고등학교,35175,3182,4163,3065,4163,117,244
인천정보과학고등학교,35183,5863,1928,5642,1928,221,259
인천정보과학고등학교,35800,48,12,43,12,5,2
인천정보과학고등학교,36002,2689,5427,2614,5427,75,270
인천종합수산물센터,35074,4949,262,4719,262,230,173
인천준법지원센터·미추홀트루엘파크,37147,869,329,847,329,22,39
인천준법지원센터·미추홀트루엘파크,37148,174,939,170,939,4,37
인천지방법원,37096,3999,76,3918,76,81,135
인천지방법원북부지원입구,89434,300,319,287,319,13,20
인천지방법원북부지원입구,89435,19,749,17,749,2,25
인천지방중소기업청입구,39087,2756,1012,2748,1012,8,125
인천체육고등학교,89233,227,349,220,349,7,19
인천체육고등학교입구,89048,70,14,68,14,2,2
인천체육고등학교입구,89049,5,99,5,99,0,3
인천축구전용경기장,36184,120,22,91,22,29,4
인천축구전용경기장,37286,2495,2701,2431,2701,64,173
인천축구전용경기장,37303,3160,1789,3095,1789,65,164
인천축구전용경기장(서희스타힐스),37558,264,1586,253,1586,11,61
인천축산농협,40454,422,757,412,757,10,39
인천축산농협,40457,560,1042,542,1042,18,53
인천축산물시장,42010,1342,953,1311,953,31,76
인천축산물시장,42011,848,1203,843,1203,5,68
인천출입국·외국인청,35127,12746,1668,12632,1668,114,480
인천출입국·외국인청,35129,1079,10513,1014,10513,65,386
인천터미널,37215,1954,28,1937,28,17,66
인천터미널사거리입구,39194,1220,4743,1205,4743,15,198
인천터미널역,37648,510,29,504,29,6,17
인천테크노밸리U1센터,40605,5008,7134,4921,7134,87,404
인천테크노밸리U1센터,40607,8435,5294,8317,5294,118,457
인천푸른빛유치원,89376,1226,102,1226,102,0,44
인천푸른빛유치원,89377,178,1194,178,1194,0,45
인천항신국제여객터미널,38652,902,440,896,440,6,44
인천항신국제여객터미널(하행),38662,301,838,261,838,40,37
인천해든초등학교,89410,1533,1061,1529,1061,4,86
인천해든초등학교,89411,1471,2694,1447,2694,24,138
인천해양과학고,38120,2035,1058,1967,1058,68,103
인천해양과학고,38566,281,259,257,259,24,18
인천향교.인천도호부청사,37124,5600,11521,5417,11521,183,570
인천향교.인천도호부청사,37125,9152,2375,8957,2375,195,384
인천향교유림회관,37059,13756,4833,13433,4833,323,619
인천향교유림회관,37062,8979,13284,8762,13284,217,742
인천환경공단입구,42930,388,83,383,83,5,15
인천힘찬종합병원,39628,5854,4141,5806,4141,48,333
인천힘찬종합병원,39629,4232,4296,4170,4296,62,284
인평자동차고,40149,12504,16132,12327,16132,177,954
인평자동차고,40151,1204,653,1204,653,0,61
인평자동차고,40152,379,1093,379,1093,0,49
인평자동차고,40787,17324,8753,17125,8753,199,869
인하국제의료센터,35643,0,9,0,9,0,0
인하대병원,35119,13398,9137,13139,9137,259,751
인하대병원,35121,3923,1797,3858,1797,65,190
인하대병원,35486,5909,5927,5725,5927,184,394
인하대병원입구,35846,6605,11674,6417,11674,188,609
인하대역,37596,20,8622,20,8622,0,288
인하대역(1번출구),37066,72964,70905,72097,70905,867,4795
인하대역(7번출구),37091,98205,70424,97236,70424,969,5620
인하대역3번출구,37127,3986,19498,3939,19498,47,782
인하대역4번출구,37122,13414,4973,13242,4973,172,612
인하대정문,37099,21720,8744,21500,8744,220,1015
인하대정문,37104,8923,21787,8746,21787,177,1023
인하대후문,37165,62057,4787,62057,4787,0,2228
인하대후문,37166,1503,1187,1494,1187,9,89
인하대후문,37167,11183,64704,11111,64704,72,2529
인향아파트,40557,8045,531,7905,531,140,285
인향아파트,40559,470,6559,444,6559,26,234
인향아파트,41464,2706,143,2688,143,18,94
인향아파트,41465,111,5899,67,5899,44,200
인혜학교후문(원욱그린타운),41473,1470,527,1462,527,8,66
인혜학교후문(원욱그린타운),41518,470,3107,458,3107,12,119
인화1리마을회관,90211,93,64,85,64,8,5
인화리종점,43473,83,56,73,56,10,4
인화성입구,90063,0,9,0,9,0,0
인화성입구,90064,15,6,10,6,5,0
인화여고,37547,4388,4214,4261,4214,127,286
인화여고,37548,7886,13112,7771,13112,115,699
일신동행정복지센터,40200,6919,3654,6791,3654,128,352
일신동행정복지센터,40205,107,2408,100,2408,7,83
일신동행정복지센터,40220,2854,2678,2829,2678,25,184
일신시장,40207,4259,5163,4233,5163,26,314
일신시장,40210,5457,2502,5299,2502,158,265
일신주공,40866,423,1128,423,1128,0,51
일신주공109동,40868,6273,4069,6185,4069,88,344
임광그대가.서창자이아파트,39514,3607,1367,3596,1367,11,165
임광그대가.서창자이아파트,39515,284,3782,278,3782,6,135
임광그대가103동,92025,3285,3293,3247,3293,38,219
임송촌,43423,11,6,11,6,0,0
임송촌,43802,97,106,95,106,2,6
임학사거리,41283,500,1930,480,1930,20,81
임학역,41290,17149,23008,16998,23008,151,1338
임학역,41292,23134,14419,22860,14419,274,1251
임학지하차도앞사거리,41287,25,3208,25,3208,0,107
임학지하차도앞사거리,41288,2268,20,2268,20,0,76
입구지,35300,41,3,40,3,1,1
입구지,35751,5,39,2,39,3,1
입구지입구,35477,22,74,22,74,0,3
입구지입구,35478,77,7,76,7,1,2
자동차매매단지,11020,227,560,218,560,9,26
자동차매매단지,11021,542,191,540,191,2,24
자동차매매단지,36094,236,4826,228,4826,8,168
자동차매매단지,37459,3561,289,3556,289,5,128
자연사박물관,43667,0,5,0,5,0,0
자이금호힐스테이트,42849,324,4263,310,4263,14,152
자이금호힐스테이트,42850,2910,282,2790,282,120,106
자이더테라스1단지,89297,1154,339,1129,339,25,49
자이더테라스1단지,89298,531,1158,512,1158,19,56
자이더테라스2단지,42864,1523,2446,1506,2446,17,132
자이더테라스2단지,42871,2721,1367,2604,1367,117,136
자이더테라스2단지(209동),89460,250,666,242,666,8,30
작은구월사거리,39239,5605,5734,5566,5734,39,377
작은구월사거리,39240,6291,6353,6222,6353,69,421
작전1동주민센터,41113,14733,8288,14631,8288,102,767
작전동삼성홈플러스,41044,16851,29750,16684,29750,167,1553
작전동삼성홈플러스,41050,18917,9122,18712,9122,205,934
작전동풍림아파트,41090,321,1236,318,1236,3,51
작전서운동행정복지센터,41103,440,2476,410,2476,30,97
작전서운동행정복지센터,41104,2549,498,2497,498,52,101
작전역,41561,7362,4957,7332,4957,30,410
작전역,41562,5433,7592,5413,7592,20,434
작전역 서해그랑블,41047,2431,2500,2394,2500,37,164
작전역 서해그랑블,41414,1196,3068,1181,3068,15,142
작전역1번출구,41095,11356,16073,11226,16073,130,914
작전역2번출구,41092,5219,6538,5205,6538,14,391
작전역3번출구,41076,8579,4295,8532,4295,47,429
작전역4번출구,41062,15093,32822,14951,32822,142,1597
작전역5번출구,41057,58237,33925,57854,33925,383,3072
작전역6번출구,41433,3733,26458,3714,26458,19,1006
작전역7번출구,41401,25467,6120,25360,6120,107,1052
작전역8번출구,41093,10061,10562,9957,10562,104,687
작전중고.여고앞,41116,3846,3161,3770,3161,76,233
작전초등학교,41127,3217,2971,3129,2971,88,206
작전초등학교,41128,3224,2391,3173,2391,51,187
작전풍림아파트,41080,832,6036,821,6036,11,228
작전풍림아파트,41091,7976,3244,7930,3244,46,374
잔다리삼거리,35519,35,33,35,33,0,2
잔다리삼거리,35559,83,60,81,60,2,4
잔다리삼거리,35856,6,7,6,7,0,0
잔다리삼거리,35857,8,4,8,4,0,0
잔다리새마을,35866,15,52,12,52,3,2
잔다리새마을,35867,23,90,23,90,0,3
잔솔밭,43944,55,22,50,22,5,2
잠진도삼거리,35743,100,18,97,18,3,3
잠진도삼거리,35744,13,264,12,264,1,9
잠진도입구,35749,24,131,24,131,0,5
잠진도입구,35750,86,61,85,61,1,4
장경리공영주차장,44141,9,43,9,43,0,1
장경리공영주차장,44190,59,7,53,7,6,2
장경리해수욕장,44092,22,46,20,46,2,2
장경리해수욕장,44191,35,17,30,17,5,1
장곡.고촌고등학교,80066,202,115,201,115,1,10
장곡.고촌고등학교,80288,52,55,51,55,1,3
장곶돈대,43931,50,36,50,36,0,2
장곶돈대,43932,18,67,18,67,0,2
장곶횟집,43118,21,9,17,9,4,1
장곶횟집,43478,19,41,19,41,0,2
장구란,90349,0,6,0,6,0,0
장구란,90354,6,1,5,1,1,0
장기동,41345,1096,180,1091,180,5,42
장기동,41346,247,3699,244,3699,3,131
장기동,41347,2342,16535,2303,16535,39,629
장기동,41348,22253,2698,22032,2698,221,831
장도초등학교,39127,371,497,371,497,0,28
장도초등학교,39129,1942,803,1917,803,25,91
장릉입구,80046,21,130,21,130,0,5
장릉입구,80047,290,2,289,2,1,9
장미아파트,37044,6691,8540,6593,8540,98,507
장미아파트,37092,21111,9953,20828,9953,283,1035
장미아파트,37094,9835,15437,9646,15437,189,842
장미아파트(19동)앞,37474,3143,3020,3094,3020,49,205
장미아파트(19동)앞,37540,2618,4038,2487,4038,131,221
장서초등학교,39965,2508,585,2481,585,27,103
장서초등학교,39966,987,6526,975,6526,12,250
장수.서창동행정복지센터,39580,4180,8656,4118,8656,62,427
장수.서창동행정복지센터,39581,8594,1966,8558,1966,36,352
장수공영차고지,39566,1159,331,700,331,459,49
장수공영차고지,92064,773,207,5,207,768,32
장수교,39336,459,555,453,555,6,33
장수교(서창동입구),39337,233,1166,219,1166,14,46
장수동,39373,820,1932,812,1932,8,91
장수동,39391,1108,1121,1095,1121,13,74
장수동,39393,4255,4955,4200,4955,55,307
장수빌라,39577,466,1093,462,1093,4,51
장수사거리,39389,12253,3747,12088,3747,165,533
장수사거리,39397,187,2448,180,2448,7,87
장수사거리,39501,2769,7099,2710,7099,59,328
장수사거리,39542,5284,403,5154,403,130,189
장수주공(청소년수련원),39417,38,2131,37,2131,1,72
장수주공(청소년수련원),39424,3122,64,3080,64,42,106
장수초등학교,39342,3273,1824,3165,1824,108,169
장수초등학교,39352,1152,2330,1133,2330,19,116
장수파출소,39543,8,655,8,655,0,22
장승마루,90028,0,15,0,15,0,0
장승마루,90029,7,0,7,0,0,0
장승마을,43200,0,30,0,30,0,1
장승마을,43714,77,2,58,2,19,2
장승백이시장,39280,3642,1545,3606,1545,36,172
장승백이시장,39282,678,3811,665,3811,13,149
장아초등학교,39873,1020,670,993,670,27,56
장아초등학교,39874,117,1661,92,1661,25,59
장안,43418,3,31,3,31,0,1
장안,43445,44,17,44,17,0,2
장안마을,43133,17,0,15,0,2,0
장안마을,43855,0,9,0,9,0,0
장안말(구초지분교)입구,90083,77,128,70,128,7,6
장안말(구초지분교)입구,90084,127,89,110,89,17,7
장안말(온천스파),43144,21,9,21,9,0,1
장안말(온천스파),43253,27,6,20,6,7,1
장안말(온천스파),43892,5,19,4,19,1,0
장안사거리,37285,15435,3409,15238,3409,197,628
장안사거리,37295,4609,16780,4462,16780,147,712
장안촌동쪽,43933,3,24,3,24,0,0
장암마을,90155,100,59,98,59,2,5
장암마을,90156,40,46,39,46,1,2
장애인복지관,37249,2438,2823,2378,2823,60,175
장애인종합복지관,43627,1,11,1,11,0,0
장인가구,39706,223,200,223,200,0,14
장자말,43142,1,31,1,31,0,1
장자말,43257,54,1,52,1,2,1
장자촌,43141,30,0,30,0,0,1
장자촌,43255,1,0,1,0,0,0
장전,43415,41,7,39,7,2,1
장전,43500,1,18,1,18,0,0
장정2리마을회관,43665,1,90,1,90,0,3
장정2리마을회관,43693,150,2,147,2,3,5
장지포,90238,1,9,1,9,0,0
장지포,90239,5,7,5,7,0,0
장천사거리,37282,1820,2264,1792,2264,28,136
장천사거리,37610,289,1188,274,1188,15,49
장천사거리,37651,429,1173,424,1173,5,53
장촌길 입구,90379,10,11,10,11,0,0
장촌길 입구,90382,14,8,14,8,0,0
장촌마을,35475,139,12,137,12,2,5
장촌마을,35476,8,169,8,169,0,5
장촌빌라,35321,222,25,214,25,8,8
장촌빌라,35397,19,165,19,165,0,6
장하,43184,2,33,2,33,0,1
장하,43204,56,0,55,0,1,1
장화교회앞,43121,20,34,15,34,5,1
장화교회앞,43539,36,13,25,13,11,1
장화리학생수련원,43426,52,61,50,61,2,3
장화리학생수련원,43474,15,18,14,18,1,1
장흥낚시터,43211,1,0,1,0,0,0
장흥낚시터,43890,6,3,6,3,0,0
장흥리종점,43643,42,16,40,16,2,1
장흥리종점,43888,16,21,13,21,3,1
장흥매점,43641,1,0,1,0,0,0
장흥매점,43891,1,4,1,4,0,0
장흥삼거리,43153,9,12,9,12,0,0
장흥삼거리,43881,9,15,9,15,0,0
장흥저수지(성공회.해든뮤지움),90081,214,103,209,103,5,10
장흥저수지(성공회.해든뮤지움),90082,67,173,61,173,6,8
재능대학교서문,36058,18435,25179,18165,25179,270,1453
재능대학교서문,36119,15396,14741,15208,14741,188,1004
재활용품수집장,43165,0,7,0,7,0,0
저수지관리소,43264,53,1,53,1,0,1
저수지휴게소,43567,16,47,16,47,0,2
저수지휴게소,43763,0,1,0,1,0,0
적두마을(월곳교회),43190,22,0,17,0,5,0
적두마을(월곳교회),43709,0,32,0,32,0,1
적석사입구,43348,8,75,6,75,2,2
적석사입구,43847,107,1,93,1,14,3
전동교회,35199,8012,5614,7706,5614,306,454
전동교회,35200,2850,8755,2798,8755,52,386
전득이고개입구,90187,12,12,7,12,5,0
전득이고개입구,90188,12,50,11,50,1,2
전들,43477,53,0,41,0,12,1
전들,43835,0,66,0,66,0,2
전등사남문,43515,128,310,111,310,17,14
전등사남문,43893,263,75,263,75,0,11
전등사동문,43521,147,651,139,651,8,26
전등사동문,43895,479,302,462,302,17,26
전소,35231,6559,5148,6433,5148,126,390
전소,35232,6289,5665,6169,5665,120,398
전원미술관앞,43387,150,7,147,7,3,5
전원미술관앞,43810,2,192,2,192,0,6
전인연립(종점),40132,97,253,93,253,4,11
절아래,90401,0,10,0,10,0,0
절아래,90402,17,3,15,3,2,0
점촌,43414,85,1,56,1,29,2
점촌,43806,1,52,1,52,0,1
젓개마을,35828,15,86,10,86,5,3
젓개마을,35829,5,7,3,7,2,0
젓개마을입구,35322,9,11,9,11,0,0
젓개마을입구,35398,0,1,0,1,0,0
정광아파트(병무청),37008,4326,53,4293,53,33,145
정광아파트(병무청),37009,26,4698,25,4698,1,157
정광아파트.만수주공11단지,39476,6986,7169,6940,7169,46,471
정광아파트.만수주공11단지,39477,7440,4599,7358,4599,82,401
정기무역,35083,2352,234,2206,234,146,86
정다운그린빌,92024,1535,3265,1519,3265,16,160
정든마을아파트,40055,1936,3373,1923,3373,13,176
정든마을아파트,40057,4021,2079,4012,2079,9,203
정병원,40413,4703,4400,4681,4400,22,303
정부인천지방합동청사,37386,36830,17719,36512,17719,318,1818
정부인천지방합동청사,37388,25966,32374,25676,32374,290,1944
정비단지,37005,2009,1621,1973,1621,36,121
정비단지,37006,918,2249,905,2249,13,105
정서진삼거리,89234,0,352,0,352,0,11
정석항공과학고,37168,29482,5463,29404,5463,78,1164
정석항공과학고,37170,9640,32263,9605,32263,35,1396
정수사입구,43404,59,15,59,15,0,2
정수사입구,43436,23,27,23,27,0,1
정왕IC(미정차),92001,1,0,1,0,0,0
정왕IC(미정차),92007,1,0,1,0,0,0
정하,43183,63,7,62,7,1,2
정하,43208,3,45,3,45,0,1
제물포시장,37310,739,801,714,801,25,51
제물포시장,37311,937,844,929,844,8,59
제물포여자중학교,37288,3926,2435,3860,2435,66,212
제물포여자중학교,37290,6385,5460,6226,5460,159,394
제물포여자중학교,37298,9821,12001,9576,12001,245,727
제물포역,37355,56119,36255,55368,36255,751,3079
제물포역,37364,34838,23937,34468,23937,370,1959
제물포역,37496,35095,43102,34252,43102,843,2606
제물포역,37498,19297,7467,19130,7467,167,892
제물포역,37502,34609,44567,34189,44567,420,2639
제물포역(동양빌딩),37339,777,4740,763,4740,14,183
제물포중학교,42064,2380,2559,2305,2559,75,164
제물포중학교,42065,2675,1733,2624,1733,51,146
제운사거리(청년창업특화거리),37175,2745,4378,2650,4378,95,237
제운사거리(청년창업특화거리),37534,2812,5313,2704,5313,108,270
제일시장,37316,7656,6678,7653,6678,3,477
제일시장,37329,11163,11075,10973,11075,190,741
제일시장사거리,37667,1211,674,1170,674,41,62
제일주유소,57020,2288,1556,2272,1556,16,128
제일주유소,57021,1177,3418,1164,3418,13,153
제일풍경채,42833,2636,3241,2625,3241,11,195
제일풍경채1차정문앞,89350,1988,1427,1974,1427,14,113
제일풍경채2차,89349,12,412,12,412,0,14
제일풍경채2차321동앞,42866,2935,1004,2865,1004,70,131
제일풍경채2차321동앞,42873,316,1150,294,1150,22,48
제일풍경채2차323동앞,42891,5247,5834,5153,5834,94,369
제일풍경채2차331동앞,42989,1744,3520,1705,3520,39,175
제적봉앞마을,90060,0,3,0,3,0,0
제적봉앞마을,90061,2,0,1,0,1,0
제적봉입구,43654,6,20,6,20,0,0
제적봉입구,43686,6,2,4,2,2,0
조광교회입구,43533,1,0,1,0,0,0
조광교회입구,43868,0,32,0,32,0,1
조달청(한양2차아파트),37511,6172,13995,5999,13995,173,672
조달청비축기지,35114,1643,5016,1600,5016,43,221
조달청비축기지,35115,4556,1922,4510,1922,46,215
조동초등학교,39464,3356,1771,3331,1771,25,170
조동초등학교,39465,22,1242,18,1242,4,42
조리미입구,80068,1526,40,1525,40,1,52
조리미입구,80069,51,1453,51,1453,0,50
조바위,90350,1,39,1,39,0,1
조바위,90351,17,0,17,0,0,0
조산,43192,7,82,6,82,1,2
조산,43334,128,21,122,21,6,4
조산교회,43172,5,38,4,38,1,1
조산교회,43338,54,5,48,5,6,1
조산초등학교,43189,113,262,112,262,1,12
조산초등학교,43593,182,25,173,25,9,6
종갱이,43180,73,108,72,108,1,6
종갱이,43288,150,102,146,102,4,8
종근당,40002,409,22,409,22,0,14
종근당,40005,9,910,9,910,0,30
종근당.충정로역,11002,95,8053,92,8053,3,271
종로약국,57005,724,1075,703,1075,21,59
종로약국,57007,1948,831,1903,831,45,92
종생마을,80161,785,126,752,126,33,30
종생마을,80162,159,1247,151,1247,8,46
종점(병무청),37014,2639,37,2569,37,70,89
종합터미널,37242,48048,22712,47576,22712,472,2358
종합터미널,39177,14981,39873,14717,39873,264,1828
종현동정보화마을,62043,23,163,23,163,0,6
종현동정보화마을,62044,164,24,161,24,3,6
좌동교차로,89371,14,51,14,51,0,2
좌동마을,42452,137,56,126,56,11,6
좌동마을,89253,75,163,67,163,8,7
좌동마을입구,42456,54,127,54,127,0,6
좌동마을입구,42928,187,47,187,47,0,7
주거단지,35118,406,373,389,373,17,25
주거단지,35120,206,852,199,852,7,35
주공12단지,35082,918,217,918,217,0,37
주공12단지,35084,529,367,521,367,8,29
주공6단지후문,40453,5004,2644,4987,2644,17,254
주공뜨란채아파트,40708,3778,3792,3724,3792,54,252
주공뜨란채아파트,40803,3955,3115,3920,3115,35,235
주공아파트,40867,410,750,402,750,8,38
주물단지,42291,980,3602,980,3602,0,152
주안1동행정복지센터,37385,6041,7585,5993,7585,48,454
주안2동치안센터,37302,7491,4836,7424,4836,67,410
주안4동행정복지센터,37333,183,268,183,268,0,15
주안4동행정복지센터,37335,81,520,80,520,1,20
주안5동행정복지센터,37526,851,962,851,962,0,60
주안7동행정복지센터,37214,20503,20995,20190,20995,313,1383
주안7동행정복지센터,37216,23305,16778,22799,16778,506,1336
주안국가산단역,37583,6494,536,6494,536,0,234
주안국가산단역,37584,14,1967,14,1967,0,66
주안남초등학교,37283,7826,7172,7630,7172,196,499
주안남초등학교,37284,12874,4884,12695,4884,179,591
주안도서관,37341,327,436,322,436,5,25
주안도서관,37342,408,328,407,328,1,24
주안매매단지,37586,382,618,382,618,0,33
주안북부역,37418,19489,15254,19418,15254,71,1158
주안북부역,37420,17618,13502,17529,13502,89,1037
주안북초등학교,37417,4638,6728,4624,6728,14,378
주안사거리,37330,17011,13152,16571,13152,440,1005
주안사거리,37514,3357,8246,3350,8246,7,386
주안시범공단,39927,252,580,252,580,0,27
주안아파트,37207,887,2139,844,2139,43,100
주안아파트,37209,1245,1421,1220,1421,25,88
주안역,37387,80586,28412,79662,28412,924,3633
주안역,37389,20102,79806,19839,79806,263,3330
주안역,37402,971,3964,956,3964,15,164
주안역,37506,24470,15991,24133,15991,337,1348
주안역센트레빌아파트,37430,8187,15489,8151,15489,36,789
주안역센트레빌아파트정문,37490,1038,909,1038,909,0,64
주안역환승정류장,37503,90485,62607,89857,62607,628,5103
주안역환승정류장,37617,148019,127892,148019,127892,0,9197
주안파크자이더플래티넘아파트,37201,14135,8710,13869,8710,266,761
주안파크자이더플래티넘아파트,37204,8911,14955,8639,14955,272,795
주안현대아파트,37358,19437,17015,19001,17015,436,1215
주원고개,39377,1363,3741,1294,3741,69,170
주원고개,39396,3506,9200,3429,9200,77,423
주적골,39510,654,2141,624,2141,30,93
주적골,39608,744,948,736,948,8,56
주택마을,90230,16,51,12,51,4,2
중고등학교,44106,58,40,47,40,11,3
중고등학교,44193,105,31,80,31,25,4
중고차매매단지엠파크허브,42038,357,724,350,724,7,36
중곡고개,43935,1,0,1,0,0,0
중구노인복지회관,35151,12047,10252,11777,10252,270,743
중구노인복지회관,35152,12769,11766,12473,11766,296,817
중구문화회관,35466,2,664,0,664,2,22
중구문화회관,35467,1645,223,1612,223,33,62
중구청,35157,3063,1667,3037,1667,26,157
중구청,35159,1095,3895,1058,3895,37,166
중구청소년수련관.하늘중학교,35824,3176,749,3016,749,160,130
중독고개,43936,21,48,19,48,2,2
중박골입구,44123,29,11,29,11,0,1
중박골입구,44194,21,5,18,5,3,0
중봉로교차로,89420,761,913,738,913,23,55
중봉로교차로,89421,256,274,248,274,8,17
중부고용노동청(인천고용센터),39222,668,841,664,841,4,50
중부고용노동청(인천고용센터),39223,696,598,686,598,10,43
중산고등학교,35868,251,546,230,546,21,26
중산고등학교,35869,500,433,481,433,19,31
중산교차로,35652,841,352,819,352,22,39
중산교차로,35653,274,2829,247,2829,27,103
중산동,35305,1850,549,1792,549,58,79
중산동(까치빌라앞),35247,537,790,519,790,18,44
중산동(중촌),35272,493,1259,485,1259,8,58
중산동(중촌),35278,25,323,20,323,5,11
중산중고등학교,35817,39,462,37,462,2,16
중산중고등학교,35818,144,344,140,344,4,16
중산중학교,35656,1879,721,1790,721,89,86
중산중학교,35657,838,1269,776,1269,62,70
중앙공영아파트,41268,4162,1132,4028,1132,134,176
중앙공원사거리,39189,718,1067,713,1067,5,59
중앙방앗간,35852,1,12,1,12,0,0
중앙방앗간,35853,4,4,4,4,0,0
중앙사료,42014,2062,1252,2012,1252,50,110
중앙사료,42015,395,957,386,957,9,45
중앙산부인과,70176,19,275,17,275,2,9
중앙산부인과,70230,486,83,462,83,24,18
중앙시장,90125,1967,475,1832,475,135,81
중앙시장.고려궁지입구,43067,879,1661,853,1661,26,84
중앙아파트,40409,652,697,646,697,6,44
중앙아파트,42315,3214,2217,3150,2217,64,181
중앙하이츠,41110,4040,11622,3954,11622,86,522
중앙호수공원입구(호반베르디움),89245,10,515,10,515,0,17
중원고등학교,55078,1972,580,1953,580,19,85
중촌,43252,150,10,144,10,6,5
중촌,43369,1,74,1,74,0,2
중촌교차로,35436,163,681,154,681,9,28
중촌교차로,35443,997,310,968,310,29,43
중혈마을,43176,4,46,4,46,0,1
중혈마을,43299,49,6,49,6,0,1
중흥S클래스,42832,2133,1419,2123,1419,10,118
중흥S클래스,42847,517,481,511,481,6,33
중흥S클래스1차,42844,460,762,453,762,7,40
중흥S클래스1차,42845,720,533,719,533,1,41
중흥S클래스2차,42771,4882,1297,4715,1297,167,205
중흥S클래스2차,42856,4141,854,3969,854,172,166
중흥마을.은하마을,55070,957,420,949,420,8,45
지랏돌,90071,168,33,167,33,1,6
지랏돌,90072,0,32,0,32,0,1
지산리입구,43310,11,5,8,5,3,0
지산리입구,43751,5,12,5,12,0,0
지산입구(용진),43538,25,14,25,14,0,1
지산입구(용진),43679,11,34,11,34,0,1
지산주택,38202,53,933,41,933,12,32
지석리마을회관,90274,3,4,3,4,0,0
지석리망향단입구,90273,10,4,10,4,0,0
지석리오현부락,90275,11,10,11,10,0,0
지석초등학교입구,90277,35,6,35,6,0,1
지식정보단지역,38373,7527,1009,7525,1009,2,284
지식정보단지역,38403,9472,1031,9447,1031,25,350
지식정보단지역,38404,313,7275,305,7275,8,252
지식정보단지역(4번출구),38380,498,9838,493,9838,5,344
진고개(5연대입구),43380,229,79,220,79,9,10
진고개(5연대입구),43794,22,249,21,249,1,9
진광횟집앞,43507,18,5,16,5,2,0
진광횟집앞,43541,12,19,10,19,2,1
진달래아파트,37600,12,705,9,705,3,23
진도로르빌아파트,37471,1818,3573,1787,3573,31,179
진두방앗간,44129,0,8,0,8,0,0
진두방앗간,44195,6,2,4,2,2,0
진산과학고등학교,40640,100,284,2,284,98,12
진산과학고등학교,40915,82,1,70,1,12,2
진산중학교,40575,1130,3186,1110,3186,20,143
진산초등학교,40614,840,3507,826,3507,14,144
진산초등학교,40633,143,181,3,181,140,10
진산초등학교,40914,400,8,257,8,143,13
진솔인더스트리,89447,197,1,192,1,5,6
진솔인더스트리,89448,3,120,0,120,3,4
진주5단지503동앞,42089,3599,3452,3571,3452,28,235
진주상가,42544,3895,317,3830,317,65,140
진주아파트2단지,42092,420,11704,408,11704,12,404
진주아파트2단지6동,42084,152,6720,149,6720,3,229
진주아파트3단지,42086,8789,173,8703,173,86,298
진주아파트4단지,42077,3881,158,3853,158,28,134
진표에너지,42548,5,316,0,316,5,10
진흥아파트,37190,3275,2531,3232,2531,43,193
진흥아파트,37193,2703,3759,2665,3759,38,215
진흥아파트,37240,6300,4296,6207,4296,93,353
진흥아파트,37243,5856,10641,5772,10641,84,549
진흥아파트,39297,7655,7696,7614,7696,41,511
집단에너지,39064,107,151,107,151,0,8
집단에너지시설,39065,114,132,111,132,3,8
짓절미,43485,21,14,19,14,2,1
짓절미,43713,10,13,10,13,0,0
찬우물,39179,1361,3577,1334,3577,27,164
찬우물,39188,2114,973,2054,973,60,102
찬우물,43048,155,362,150,362,5,17
찬우물약수터,43851,143,265,133,265,10,13
참빛감리교회,42437,16461,11658,16008,11658,453,937
참좋은집,36160,300,8,296,8,4,10
참좋은집,36161,16,338,8,338,8,11
창골,43549,231,113,225,113,6,11
창리,43052,131,285,128,285,3,13
창리,43053,283,317,263,317,20,20
창리,43054,264,266,261,266,3,17
창리,43902,22,22,19,22,3,1
창리,43903,1,0,1,0,0,0
창신초등학교,42620,3020,1627,3003,1627,17,154
창신초등학교,42621,2501,3022,2470,3022,31,184
창영어린이공원,36168,0,28,0,28,0,0
창후1리마을회관,43595,114,0,108,0,6,3
창후1리마을회관,43783,3,162,3,162,0,5
창후리입구,43604,160,23,158,23,2,6
창후리입구,43830,64,225,63,225,1,9
창후리종점,43774,26,119,26,119,0,4
창후정미소,43461,73,0,71,0,2,2
창후정미소,43600,17,43,17,43,0,2
채석장,38179,1317,469,1277,469,40,59
천곡,43409,150,2,138,2,12,5
천곡,43827,19,167,18,167,1,6
천촌,43411,1,78,1,78,0,2
천촌,43795,138,0,130,0,8,4
철곶,43653,5,22,4,22,1,0
철곶,43759,13,3,9,3,4,0
철산리검문소,43957,10,34,9,34,1,1
철산리검문소,43958,33,6,32,6,1,1
철산리입구,43685,20,15,20,15,0,1
철산리입구,43741,6,29,3,29,3,1
첨단초등학교,92014,321,3474,317,3474,4,126
청광플러스원102동앞,39946,1844,234,1844,234,0,69
청광플러스원아파트,39775,5976,2474,5921,2474,55,281
청광플러스원아파트,39786,1844,7117,1790,7117,54,298
청능로사거리,39622,42006,16707,41358,16707,648,1957
청능로사거리,39623,19076,40906,18740,40906,336,1999
청라1동행정복지센터,42744,13003,5208,12913,5208,90,607
청라1동행정복지센터,42745,6890,10688,6752,10688,138,585
청라1호문화공원,89470,19,2,17,2,2,0
청라1호문화공원,89471,4,0,4,0,0,0
청라2동행정복지센터,89039,3065,511,3020,511,45,119
청라2동행정복지센터,89042,1067,3063,996,3063,71,137
청라3동행정복지센터,89374,1431,4298,1420,4298,11,190
청라3동행정복지센터,89375,5348,948,5342,948,6,209
청라BRT차고지입구,89336,153,258,8,258,145,13
청라BRT차고지입구,89337,519,62,417,62,102,19
청라고등학교,42784,2439,910,2398,910,41,111
청라고등학교,42785,835,2232,803,2232,32,102
청라골프아카데미,89255,146,64,146,64,0,7
청라골프아카데미,89256,68,111,68,111,0,5
청라국제도서관,42922,68,225,67,225,1,9
청라국제도서관,42923,309,144,306,144,3,15
청라국제도시역,89270,46379,648,46258,648,121,1567
청라국제도시역(경명대로),89034,9132,10824,9114,10824,18,665
청라국제도시역(서부산단방향),89043,26331,27405,26141,27405,190,1791
청라국제도시역(청라국제교방향),89215,27885,23241,27808,23241,77,1704
청라국제어린이집,89289,207,39,202,39,5,8
청라국제업무단지(골드클래스),42984,766,541,752,541,14,43
청라꽃농원,42991,136,86,136,86,0,7
청라달튼국제학교,42895,1246,1382,1173,1382,73,87
청라달튼국제학교,89121,1453,814,1438,814,15,75
청라도,42931,13,101,13,101,0,3
청라도,89127,8,84,8,84,0,3
청라디이스트,42961,160,1037,111,1037,49,39
청라디이스트,89045,5,25,0,25,5,1
청라디이스트(562동),42962,1624,3521,1617,3521,7,171
청라디이스트(567동),89017,1031,205,1017,205,14,41
청라로데오시티포레안,89419,75,143,75,143,0,7
청라로봇랜드,89246,34,19,22,19,12,1
청라로봇랜드,89247,2,129,0,129,2,4
청라모아미래도아파트604동,89344,1843,1138,1836,1138,7,99
청라모아미래도아파트정문,89353,78,212,76,212,2,9
청라백세요양병원,42944,213,85,211,85,2,9
청라백세요양병원,89179,92,179,92,179,0,9
청라복합문화센터,89218,161,1680,161,1680,0,61
청라복합문화센터,89219,894,263,876,263,18,38
청라센텀로제비앙,89295,1371,1161,1363,1161,8,84
청라센텀로제비앙,89296,1246,1160,1230,1160,16,80
청라센텀로제비앙정문앞,89346,32,53,32,53,0,2
청라센트럴에일린의뜰,42834,4056,3544,4029,3544,27,253
청라센트럴에일린의뜰104동,42990,4150,1697,4115,1697,35,194
청라센트럴에일린의뜰106동,42892,9557,4752,9398,4752,159,476
청라스타필드,89417,21,74,21,74,0,3
청라스타필드,89418,104,527,102,527,2,21
청라시티프라디움,89334,1513,1741,1501,1741,12,108
청라시티프라디움,89335,2318,857,2287,857,31,105
청라우미린,42862,490,4274,476,4274,14,158
청라우미린아파트,89290,2818,9324,2798,9324,20,404
청라웰카운티221동,89288,43,337,37,337,6,12
청라웰카운티223동,42997,1109,246,1090,246,19,45
청라자이,42742,11949,3522,11724,3522,225,515
청라중앙호수공원입구,89021,12193,8773,12125,8773,68,698
청라중앙호수공원입구,89024,7498,13011,7472,13011,26,683
청라중학교,42848,1096,2023,1076,2023,20,103
청라초등학교,89281,5327,7137,5311,7137,16,415
청라초등학교,89282,4801,6301,4755,6301,46,370
청라파크자이상가,89299,536,824,532,824,4,45
청라파크자이상가,89300,495,730,491,730,4,40
청라푸르지오,89217,719,1323,719,1323,0,68
청라한양수자인레이크블루,89348,2532,1854,2470,1854,62,146
청라한양수자인레이크블루,89351,2008,1526,1999,1526,9,117
청라한화꿈에그린,89123,1449,729,1449,729,0,72
청라한화꿈에그린,89124,604,922,604,922,0,50
청라호반베르디움.포리공원,42899,1881,479,1829,479,52,78
청라호반베르디움.포리공원,42919,765,2027,741,2027,24,93
청라호수공원(남측),42861,3022,956,2957,956,65,132
청라호수공원(남측),42863,1353,2551,1320,2551,33,130
청라호수공원한신더휴,42870,5786,620,5530,620,256,213
청라호수공원한신더휴아파트,89291,13478,6098,13332,6098,146,652
청라힐스테이트,42987,765,2481,739,2481,26,108
청라힐스테이트,42988,3165,480,3026,480,139,121
청람중학교,89018,1583,1950,1516,1950,67,117
청람중학교,89019,2313,2171,2273,2171,40,149
청람초등학교,89279,5957,8792,5940,8792,17,491
청람초등학교,89280,8920,7347,8778,7347,142,542
청량중학교,38086,10983,3947,10841,3947,142,497
청련사입구,43766,43,170,43,170,0,7
청련사입구,43841,128,10,128,10,0,4
청룡정,41633,132,4,126,4,6,4
청룡정,41634,0,217,0,217,0,7
청소년수련관,42612,2363,38,2297,38,66,80
청소년수련관,42613,67,2767,23,2767,44,94
청소년수련관,43078,53,30,49,30,4,2
청소년수련관,43079,23,9,23,9,0,1
청소년수련관.어린이과학관,41307,12601,10133,12353,10133,248,757
청소년수련관.어린이과학관,41308,7682,9452,7510,9452,172,571
청송1단지.중흥S클래스,80090,99,156,99,156,0,8
청송1단지.중흥S클래스,80102,634,218,628,218,6,28
청송2.3단지,80089,111,76,111,76,0,6
청송2.3단지,80101,274,82,273,82,1,11
청송마을.성우오스타,80329,131,74,130,74,1,6
청송부락,90092,0,5,0,5,0,0
청송부락,90093,10,0,10,0,0,0
청양골,42775,0,46,0,46,0,1
청운대삼거리(하늘꿈교회),37433,5582,4489,5453,4489,129,335
청운대삼거리(하늘꿈교회),37500,2932,3528,2890,3528,42,215
청운대후문.한전제물포지사,37632,387,1166,369,1166,18,51
청운대후문.한전제물포지사,37633,163,1397,159,1397,4,52
청정주말농장,39852,8,230,8,230,0,7
청천농장,40538,164,1614,163,1614,1,59
청천농장,42511,1299,261,1283,261,16,52
청천농장(종점),40520,3646,15,3565,15,81,122
청천농장입구,40558,431,233,422,233,9,22
청천농장입구,40809,0,630,0,630,0,21
청천도서관,40426,1323,2060,1316,2060,7,112
청천도서관,40427,1110,770,1082,770,28,62
청천동,40808,247,8,247,8,0,8
청천동무지개아파트,40617,783,3280,765,3280,18,135
청천동무지개아파트,40618,3247,918,3219,918,28,138
청천중학교,40449,1398,2675,1371,2675,27,135
청천중학교,40455,1468,2401,1445,2401,23,128
청천천공영주차장,40896,351,1464,339,1464,12,60
청천천공영주차장,41639,447,1438,435,1438,12,62
청천초등학교,40582,3379,5494,3234,5494,145,295
청천초등학교,40586,19099,6384,18866,6384,233,849
청천초등학교,40587,4108,12013,4016,12013,92,537
청천초등학교후문,40574,1306,12070,1271,12070,35,445
청천초등학교후문,40579,12669,1204,12514,1204,155,462
청천치안센터,40533,20496,11851,20261,11851,235,1078
청천치안센터,40537,7302,8818,7169,8818,133,537
청천푸르지오아파트,40488,10958,100,10739,100,219,368
청천푸르지오아파트,40515,12646,1234,12577,1234,69,462
청천푸르지오아파트,40516,1394,9255,1385,9255,9,354
청천푸르지오아파트,40811,7723,1444,7692,1444,31,305
청천푸르지오아파트,40812,716,4704,707,4704,9,180
청천푸르지오아파트,40894,17,2202,17,2202,0,73
청천하우스디아파트,40475,5943,1800,5852,1800,91,258
청천하우스디아파트,40477,594,4244,577,4244,17,161
청학동.한국전력남인천지사,38230,3542,3954,3478,3954,64,249
청학동.한국전력남인천지사,38239,7110,6427,6938,6427,172,451
청학사거리,38256,22686,13074,22262,13074,424,1192
청학사거리,38259,9248,15445,9127,15445,121,823
청학사거리,38509,1499,1977,1486,1977,13,115
청학아파트,38236,9249,5345,9085,5345,164,486
청학아파트,38341,6478,7289,6357,7289,121,458
청학중학교,38160,4037,5931,3984,5931,53,332
청학중학교,38161,3364,1996,3307,1996,57,178
청학중학교,38496,1622,740,1592,740,30,78
청학초등학교,38181,3176,3632,3124,3632,52,226
청학초등학교,38185,3114,2901,3087,2901,27,200
청학초등학교,38190,1915,2616,1819,2616,96,151
체육공원,90214,18,15,16,15,2,1
체육공원앞,35605,4,356,4,356,0,12
체육공원앞,35606,378,4,378,4,0,12
초은고등학교,89025,7457,7124,7415,7124,42,486
초은고등학교,89026,3548,8625,3518,8625,30,405
초정마을,41252,3528,2632,3484,2632,44,205
초정마을,41254,2197,1132,2160,1132,37,110
초지,43016,9,37,8,37,1,1
초지대교,43017,154,428,152,428,2,19
초지대교,43071,1330,416,1260,416,70,58
초지대교,43106,230,587,224,587,6,27
초지리,43026,138,201,127,201,11,11
초지리,43093,6,80,4,80,2,2
초지삼거리,43112,40,53,40,53,0,3
초지삼거리,43147,4,20,4,20,0,0
초지삼거리,43508,20,73,20,73,0,3
초지진,43024,19,124,19,124,0,4
초지진,43025,229,126,217,126,12,11
초지큰말,43260,13,0,12,0,1,0
초지큰말,43512,8,9,7,9,1,0
축현초등학교.인천시립박물관,38151,4519,2554,4403,2554,116,235
축현초등학교.인천시립박물관,38152,2391,4140,2344,4140,47,217
축협,43061,1266,685,1206,685,60,65
충렬사,43326,15,0,15,0,0,0
충렬사,43629,42,25,42,25,0,2
충성아파트,40117,680,2004,665,2004,15,89
충정로역2호선,22064,10707,97,10700,97,7,360
치마바위,43247,8,16,8,16,0,0
치마바위,43646,33,4,30,4,3,1
카페거리,35727,29,29,29,29,0,1
카페거리,35728,16,47,16,47,0,2
칼빈매니토바국제학교,38370,1885,4183,1883,4183,2,202
칼빈매니토바국제학교,38435,3216,565,3116,565,100,126
칼빈매니토바국제학교,38500,4767,3472,4674,3472,93,274
캐슬해모로,39845,775,109,775,109,0,29
캐슬해모로,39846,4730,470,4699,470,31,173
캐슬해모로,39848,332,595,327,595,5,30
캐슬해모로,39849,710,3144,692,3144,18,128
캠퍼스타운역,38419,11054,16943,10991,16943,63,933
캠퍼스타운역,38420,8208,7998,8127,7998,81,540
캠퍼스타운역(3번출구),38388,30,2685,25,2685,5,90
캠퍼스타운역(3번출구),38717,572,27,569,27,3,19
커넬워크,38415,874,2770,867,2770,7,121
커넬워크,38417,2943,1440,2927,1440,16,146
커넬워크(4동),38527,607,1213,593,1213,14,60
컨벤시아,38372,699,2235,693,2235,6,97
코세스물류창고,89197,85,2,84,2,1,2
코스모스아파트,42098,299,1108,293,1108,6,46
코오롱더프라우,38439,220,814,211,814,9,34
코오롱더프라우,38440,901,166,894,166,7,35
코오롱아파트작전중.고.여고,41117,2960,4257,2907,4257,53,240
"쿠팡16,17센터",35865,187,332,187,332,0,17
쿠팡물류센터,89157,1,477,1,477,0,15
큐티엘,90218,11,0,11,0,0,0
큰말,43937,30,0,30,0,0,1
큰말,43938,0,15,0,15,0,0
큰말,43949,10,8,10,8,0,0
큰무리선착장,35710,271,117,269,117,2,12
큰무리선착장,35712,351,572,348,572,3,30
큰방죽사거리,39144,2829,3397,2775,3397,54,207
큰방죽사거리,39145,1397,3120,1354,3120,43,150
큰방죽삼거리,39575,151,180,151,180,0,11
큰방죽삼거리,39576,64,516,64,516,0,19
큰산너머입구,44013,16,151,16,151,0,5
큰산너머입구,44014,183,9,183,9,0,6
킹스빌타운,41315,3129,3242,3076,3242,53,212
타운하우스공장.명진화학,89226,5,276,5,276,0,9
타운하우스공장.명진화학,89227,224,10,191,10,33,7
탄토 마을,90381,20,0,17,0,3,0
탄토마을,90378,4,11,4,11,0,0
탑재,43115,7,48,6,48,1,1
탑재,43327,300,186,296,186,4,16
탑재,43579,235,262,227,262,8,16
태경아파트,38275,8404,8676,8265,8676,139,569
태산.대진아파트,38294,2485,2216,2470,2216,15,156
태산아파트,41193,7542,11260,7443,11260,99,626
태산아파트,42227,112,227,110,227,2,11
태산아파트·하나아파트,41578,1156,2219,1156,2219,0,112
태양공단,42147,2396,1368,2333,1368,63,125
태양공단,42148,2835,2076,2779,2076,56,163
태양주택,40204,20,1116,19,1116,1,37
태영아파트,42298,3551,3405,3461,3405,90,231
태영아파트,42300,3546,3503,3422,3503,124,234
태평1차아파트,39241,3979,321,3979,321,0,143
태평1차아파트,39242,224,3936,224,3936,0,138
태평1차아파트,39516,9506,1936,9431,1936,75,381
태평1차아파트,39517,2128,10961,2111,10961,17,436
태평2차아파트,39225,12156,3729,12111,3729,45,529
태평2차아파트,39518,3406,8272,3297,8272,109,389
태평아파트,38083,7451,7149,7373,7149,78,486
태평아파트,41183,1156,185,1136,185,20,44
태평아파트.주안한신휴플러스아파트,37180,2718,4387,2633,4387,85,236
태평아파트.주안한신휴플러스아파트,37183,1286,1811,1235,1811,51,103
태평아파트1차(A),42326,4447,12510,4383,12510,64,565
태평아파트1차(B),42325,11595,3985,11429,3985,166,519
태평아파트2차(A),42317,2142,3059,2121,3059,21,173
태평아파트2차(B),42318,4802,2950,4729,2950,73,258
태평아파트입구,39274,128,1671,128,1671,0,59
태평아파트입구,39276,708,264,702,264,6,32
태평양산업,39066,2522,610,2521,610,1,104
태평양인천물류센터,42012,1708,2274,1686,2274,22,132
태화.두진아파트,39441,8698,6421,8575,6421,123,503
태화두진아파트,39445,6983,7061,6919,7061,64,468
태화아파트,37413,4866,3659,4839,3659,27,284
태화아파트,37416,5850,4980,5820,4980,30,361
태화아파트,40545,8906,3846,8709,3846,197,425
태화아파트,40810,1529,49,1529,49,0,52
태화한진아파트,41132,4896,2555,4872,2555,24,248
태화한진아파트612동,41135,1023,2783,1003,2783,20,126
택리,43233,53,5,46,5,7,1
택리,43859,11,45,11,45,0,1
택리교회,43229,17,90,15,90,2,3
택리교회,43860,87,16,76,16,11,3
테니스장,40456,263,236,262,236,1,16
테일코리아,89430,228,104,223,104,5,11
테일코리아,89431,475,172,468,172,7,21
테크노파크IT센타,39726,736,2290,720,2290,16,100
테크노파크IT센타,39727,2361,2118,2314,2118,47,149
테크노파크IT센터,39938,3162,5442,3094,5442,68,286
테크노파크역,38421,28326,15426,28024,15426,302,1458
테크노파크역,38422,25112,26408,24961,26408,151,1717
토지금고,37114,8143,2277,7982,2277,161,347
토지금고,37115,3842,11457,3740,11457,102,509
토지금고시장,37102,17812,14334,17448,14334,364,1071
토지금고시장앞,37509,11002,9443,10858,9443,144,681
트러스(서구장애인직업재활시설),42809,328,3,316,3,12,11
트러스(서구장애인직업재활시설),42810,2,207,2,207,0,6
트레지움1단지.다니엘병원,55076,2718,947,2683,947,35,122
트레지움1단지.다니엘병원,55077,807,2143,787,2143,20,98
트루엘에코시티아파트(후문),42049,1602,1023,1576,1023,26,87
트루엘에코시티아파트(후문),42050,1324,1342,1290,1342,34,88
파라곤보타닉파크,89422,2587,61,2565,61,22,88
파라곤보타닉파크(고산터널),89395,3768,1035,3745,1035,23,160
파라다이스공원,43391,216,14,204,14,12,7
파라다이스공원,43828,6,233,6,233,0,7
파라다이스시티역,35748,5,41,2,41,3,1
팔도주유소,40175,310,336,310,336,0,21
팔도주유소,40774,10555,7104,10326,7104,229,588
팬더아파트,39968,442,3,440,3,2,14
팬더아파트,39980,2,351,2,351,0,11
펜션마을,90392,0,18,0,18,0,0
펜션마을,90393,8,0,5,0,3,0
평전,43258,5,50,5,50,0,1
평화전망대,43743,44,63,42,63,2,3
평화전망대,43760,40,5,40,5,0,1
포내교회,35874,1,0,1,0,0,0
포내교회,35875,2,23,0,23,2,0
포도마을,55039,2493,2517,2461,2517,32,167
포도마을사거리.현대백화점.이마트,55055,10582,9149,10487,9149,95,657
포도밭,43939,9,11,9,11,0,0
포도밭,43940,12,8,12,8,0,0
포레시안101동앞,39729,6202,5529,6106,5529,96,391
포레시안101동앞,39730,4251,3856,4154,3856,97,270
포스코타워앤쉐라톤호텔,38491,2902,1379,2864,1379,38,142
푸르지오더베뉴(3216동),89442,496,1988,496,1988,0,82
푸르지오더베뉴후문,89423,7,1627,7,1627,0,54
푸르지오더스카이,35844,3287,1376,3238,1376,49,155
푸르지오더스카이,35845,1833,1637,1780,1637,53,115
푸르지오더스카이256동,35508,1847,583,1812,583,35,81
푸르지오더스카이256동,35509,1177,1526,1087,1526,90,90
푸르지오월드마크,,7483,10230,7314,10230,169,590
푸르지오하버뷰,38456,170,472,170,472,0,21
푸르지오하버뷰,38522,1385,2944,1355,2944,30,144
푸른초장,90052,1,92,0,92,1,3
푸른초장,90053,57,1,55,1,2,1
풍류산,90129,0,17,0,17,0,0
풍류산,90130,16,0,13,0,3,0
풍림1단지정문,70007,0,896,0,896,0,29
풍림1차205동,35255,2277,4780,2249,4780,28,235
풍림1차205동,35256,7703,3643,7628,3643,75,378
풍림1차아파트,42969,12960,5089,12898,5089,62,601
풍림1차아파트,42970,4444,10954,4406,10954,38,513
풍림2.3차아파트,38350,10003,2172,9981,2172,22,405
풍림2단지,70010,14,1466,8,1466,6,49
풍림2차아파트,38049,5041,14102,5002,14102,39,638
풍림2차아파트,38050,7768,5463,7585,5463,183,441
풍림3단지정문,70003,212,277,193,277,19,16
풍림3차아파트,42366,8458,4537,8421,4537,37,433
풍림6단지,35124,2267,440,2205,440,62,90
풍림아이원,36114,199,1970,194,1970,5,72
풍림아이원,36115,7469,1958,7360,1958,109,314
풍림아이원,36121,2395,8831,2354,8831,41,374
풍림아이원,41441,4144,2267,4080,2267,64,213
풍림아이원1차·금호어울림아파트,42642,5593,20,5478,20,115,187
풍림아이원1차·금호어울림아파트,42646,23,4684,16,4684,7,156
풍림아이원2차아파트,42485,10621,57,10399,57,222,355
풍림아이원4차아파트,42645,13,4984,8,4984,5,166
풍림아이원아파트,37034,19716,8866,19263,8866,453,952
풍림아파트,36122,6493,522,6315,522,178,233
풍림아파트,37245,23771,7082,23341,7082,430,1028
풍림아파트,37246,6126,12319,6051,12319,75,614
풍림아파트,38255,3739,5318,3694,5318,45,301
풍림아파트,39162,8295,12349,8182,12349,113,688
풍림아파트,39163,13472,6008,13352,6008,120,649
풍림아파트,41374,2752,2916,2723,2916,29,188
풍림아파트,70008,645,10,624,10,21,21
풍림아파트(소래마을),39120,1274,3777,1252,3777,22,168
풍림아파트104동,40898,7639,6458,7472,6458,167,469
풍림아파트104동,40899,5012,5652,4961,5652,51,355
풍림아파트상가,70043,333,375,305,375,28,23
풍림아파트상가,70044,356,165,337,165,19,17
풍림엑슬루타워,42830,5962,7405,5944,7405,18,445
풍무역,80167,391,5277,389,5277,2,188
풍무역,80168,3712,373,3700,373,12,136
풍물시장,35054,335,1078,314,1078,21,47
풍물시장,35055,94,3,94,3,0,3
풍물시장,43941,76,7199,65,7199,11,242
풍산빌라 입구,90384,17,8,17,8,0,0
풍산특수금속,90219,20,9,20,9,0,0
프라임,39643,4697,1166,4697,1166,0,195
프리상뜨아파트,40230,100,4469,97,4469,3,152
프린피아통합물류센터,89235,307,5,305,5,2,10
하나개삼거리,35733,9,78,9,78,0,2
하나개삼거리,35734,9,39,9,39,0,1
하나개해수욕장,35737,373,1274,370,1274,3,54
하나글로벌캠퍼스,89444,252,320,241,320,11,19
하나글로벌캠퍼스,89445,97,3481,91,3481,6,119
하나금융그룹통합데이터센터,89265,192,1769,189,1769,3,65
하나금융그룹통합데이터센터,89294,326,128,324,128,2,15
하나로쇼핑,37118,3384,7603,3196,7603,188,366
하나모터스,89451,45,0,45,0,0,1
하나모터스,89452,0,110,0,110,0,3
하나아파트,37052,9192,2925,9072,2925,120,403
하나아파트,40546,1122,1524,1117,1524,5,88
하나아파트,41250,5535,6690,5459,6690,76,407
하나아파트,41574,1670,15,1650,15,20,56
하늘도시중심상가,35821,2070,387,2004,387,66,81
하늘도시중심상가,35822,392,2012,375,2012,17,80
하늘문화센터,35826,2,32,2,32,0,1
하늘문화센터,35827,11,2,11,2,0,0
하늘문화센터입구,35766,2,70,2,70,0,2
하늘문화센터입구,35767,18,2,18,2,0,0
하늘중학교,35823,533,1396,497,1396,36,64
하늘초등학교후문,35499,258,251,254,251,4,16
하늘초등학교후문,35500,146,735,102,735,44,29
하늘휴게소,70220,2461,10098,2461,10098,0,418
하늘휴게소,70221,8887,2574,8883,2574,4,382
하룩,43157,40,214,36,214,4,8
하룩,43281,211,49,207,49,4,8
하리마을회관,90243,2,11,2,11,0,0
하리마을회관,90244,11,0,10,0,1,0
하리선착장,90240,5,28,5,28,0,1
하야동,41438,527,672,522,672,5,39
하야동,41439,677,850,662,850,15,50
하얀마을,55035,2021,2406,2012,2406,9,147
하얀집민박,43440,10,1,5,1,5,0
하얀집민박,43497,4,16,4,16,0,0
하얏트호텔,35028,1146,9000,1122,9000,24,338
하얏트호텔,35206,1905,3539,1887,3539,18,181
하우고개,43275,74,142,73,142,1,7
하우고개,43577,141,62,124,62,17,6
하우스앞,43174,27,1,27,1,0,0
하우스앞,43231,1,24,1,24,0,0
하우스토리,41569,195,344,178,344,17,17
하우스토리,41570,126,1525,117,1525,9,55
하우스토리,41606,554,563,544,563,10,37
하우스토리,41626,735,485,734,485,1,40
하우스토리만수아파트,39301,1603,982,1564,982,39,86
하일부락입구,43967,0,4,0,4,0,0
하일부락입구,43971,0,6,0,6,0,0
하점공단,43448,1,46,1,46,0,1
하점공단,43755,16,19,12,19,4,1
하점면사무소,43738,247,125,235,125,12,12
하점면사무소,43834,109,208,97,208,12,10
하점순복음교회,90222,176,5,175,5,1,6
하점순복음교회,90223,5,46,2,46,3,1
하점우체국,43817,605,82,538,82,67,22
하점우체국,43838,70,549,63,549,7,20
하점초등학교,43739,4,98,4,98,0,3
하점초등학교,43836,125,10,111,10,14,4
하정초등학교,40044,1387,895,1358,895,29,76
학마을서원아파트,41652,16,5,16,5,0,0
학마을한진아파트정문,41293,2309,3162,2274,3162,35,182
학산사거리,37025,6507,313,6353,313,154,227
학산사거리,37027,277,3481,266,3481,11,125
학산사거리,37562,1587,1347,1526,1347,61,97
학산소극장,37169,19698,3361,19661,3361,37,768
학산소극장,37173,7474,17474,7442,17474,32,831
학생안전체험관,39284,2258,4347,2196,4347,62,220
학익.원흥아파트,37015,2125,62,2092,62,33,72
학익2동행정복지센터,37150,14071,7041,13629,7041,442,703
학익2동행정복지센터,37151,7768,13709,7541,13709,227,715
학익고등학교,37029,9851,3026,9610,3026,241,429
학익고등학교,37505,3165,10158,3073,10158,92,444
학익동구치소,37139,329,836,329,836,0,38
학익동성당앞,37630,1419,32,1370,32,49,48
학익동성당앞,37631,77,668,75,668,2,24
학익사거리,37058,13,503,13,503,0,17
학익사거리,37075,3095,1458,3048,1458,47,151
학익사거리,37077,2238,5955,2162,5955,76,273
학익사거리(동아풍림아파트),37084,11956,4836,11653,4836,303,559
학익사거리(동아풍림아파트),37089,9976,10064,9720,10064,256,668
학익시장,37106,14934,5235,14628,5235,306,672
학익시장,37112,3909,12608,3811,12608,98,550
학익시장(법원검찰청),37080,10282,4304,10074,4304,208,486
학익시장앞,37082,4122,5193,4056,5193,66,310
학익여자고등학교,37140,568,1097,556,1097,12,55
학익여자고등학교,37566,465,1142,464,1142,1,53
학익풍림아파트,37487,20,2768,20,2768,0,92
한가라지고개,90157,7,1,7,1,0,0
한가라지고개,90158,11,15,10,15,1,0
한가라지입구,90159,11,9,11,9,0,0
한가라지입구,90160,8,8,8,8,0,0
한가람마을우미린.호수이편한세상,80318,1166,3036,1161,3036,5,140
한강센트럴블루힐.모아엘가2차,80375,236,330,236,330,0,18
한국가스공사,39061,798,886,798,886,0,56
한국가스공사,89273,149,552,149,552,0,23
한국가스공사,89274,127,482,126,482,1,20
한국가스공사인천지역본부,89114,29,90,24,90,5,3
한국가스공사인천지역본부,89115,35,29,34,29,1,2
한국건설생활환경시험연구원,39312,440,373,420,373,20,27
한국건설생활환경시험연구원,39315,733,2996,728,2996,5,124
한국공항공사,25002,86,1097,85,1097,1,39
한국공항공사,25144,10,28,8,28,2,1
한국국토정보공사인천북부지사,42278,5333,6079,5227,6079,106,380
한국국토정보공사인천북부지사,42280,6351,3596,6213,3596,138,331
한국글로벌셰프고등학교,43246,217,113,211,113,6,11
한국글로벌셰프고등학교,43381,69,83,69,83,0,5
한국도심공항터미널,35400,13,86,8,86,5,3
한국도심공항터미널,35408,19,163,19,163,0,6
한국도심공항터미널,35417,89,14,89,14,0,3
한국도심공항터미널앞,35645,41,8,36,8,5,1
한국마쓰이,39055,1073,1312,1073,1312,0,79
한국마쓰이,39057,3203,1458,3203,1458,0,155
한국만화박물관,40583,5302,11980,5232,11980,70,576
한국무역센터.삼성역,23201,1862,11,1862,11,0,62
한국무역센터.삼성역,23251,269,1732,269,1732,0,66
한국산업단지공단,39060,939,64,939,64,0,33
한국산업단지공단,39067,82,833,82,833,0,30
한국생산기술연구원,38448,326,587,315,587,11,30
한국생산기술연구원(주조기술센터),42271,404,619,399,619,5,34
한국생산기술연구원(주조기술센터),42719,284,244,283,244,1,17
한국샤프(로얄금속),40600,2370,3689,2356,3689,14,201
한국선교역사기념관,40673,2022,789,1953,789,69,93
한국아파트,37017,1651,8652,1616,8652,35,343
한국아파트,38154,2663,1537,2628,1537,35,140
한국아파트,40714,108,2278,100,2278,8,79
한국아파트,40715,2969,112,2949,112,20,102
한국아파트,40790,15731,16172,15539,16172,192,1063
한국아파트,40791,15779,12379,15587,12379,192,938
한국아파트,40792,3843,14090,3773,14090,70,597
한국아파트,40816,11239,9275,11132,9275,107,683
한국아파트,41206,6541,4122,6437,4122,104,355
한국아파트,41208,2628,4173,2549,4173,79,226
한국아파트,80057,2301,48,2299,48,2,78
한국전력,42947,108,783,108,783,0,29
한국지엠청라주행시험장,89412,216,329,208,329,8,18
한국지엠청라주행시험장,89413,407,253,406,253,1,22
한국지엠출고문,40560,3712,6881,3669,6881,43,353
한국지엠출고문,40570,5642,3769,5615,3769,27,313
한국콘베어공업,92049,8,0,8,0,0,0
한국타이어인천물류센터,89221,474,1210,458,1210,16,56
한국타이어인천물류센터,89222,422,810,417,810,5,41
한국특수주물(주),42575,382,297,382,297,0,22
한국폴리텍2대학남인천캠퍼스,37448,1064,927,1060,927,4,66
한국폴리텍2대학남인천캠퍼스,37450,761,538,747,538,14,43
한남시티플라자,40253,20373,12402,20221,12402,152,1092
한들마을입구(유아교육진흥원),42370,900,3644,842,3644,58,151
한들마을입구(유아교육진흥원),42371,3219,1190,3147,1190,72,146
한라비발디,35459,8278,3204,8124,3204,154,382
한라비발디,35460,6985,14388,6848,14388,137,712
한라비발디,42878,46,0,46,0,0,1
한라비발디,42879,2,26,2,26,0,0
한라비발디,89180,2113,1211,2103,1211,10,110
한라비발디,89181,1418,2688,1414,2688,4,136
한라비발디정문,89373,57,1323,51,1323,6,46
한라비발디후문.화성파크드림,35658,721,1441,618,1441,103,72
한라시멘트,35291,125,466,89,466,36,19
한라아파트,39117,1414,4932,1371,4932,43,211
한라아파트,39118,6129,1693,5975,1693,154,260
한림병원,41130,13027,9604,12993,9604,34,754
한림병원,41131,10358,15976,10308,15976,50,877
한미반도체,42754,586,1454,586,1454,0,68
한미반도체,42755,254,278,250,278,4,17
한빛초교앞,39773,1521,7330,1501,7330,20,295
한빛초교앞,39774,6406,2644,6341,2644,65,301
한사랑어린이집,42461,13,111,13,111,0,4
한성아파트,89020,699,1427,691,1427,8,70
한성자동차학원,42091,336,707,336,707,0,34
한수조경,43681,6,6,5,6,1,0
한수조경,43882,5,3,1,3,4,0
한스엔지니어링,42276,349,159,342,159,7,16
한스엔지니어링,42279,440,543,431,543,9,32
한신더휴스카이파크,35654,930,923,909,923,21,61
한신더휴스카이파크,35655,1625,702,1608,702,17,77
한신더휴테라스,35761,103,29,102,29,1,4
한신더휴테라스,35762,17,62,17,62,0,2
한신빌리지(A),42249,706,2660,702,2660,4,112
한신빌리지(B),42246,4241,747,4188,747,53,166
한신빌리지(C),42229,2552,645,2500,645,52,106
한신빌리지아파트,42230,529,858,506,858,23,46
한신삼부아파트,40806,2170,3015,2170,3015,0,172
한신아파트,37262,5392,3960,5361,3960,31,311
한신아파트,37264,8377,9913,8265,9913,112,609
한신아파트,37267,12374,9120,12215,9120,159,716
한신아파트,41066,2203,1567,2198,1567,5,125
한신아파트,41067,2239,1895,2218,1895,21,137
한신아파트,42095,36,1167,20,1167,16,40
한신휴아파트,40245,5862,114,5795,114,67,199
한신휴아파트,42105,39589,18525,38947,18525,642,1937
한신휴아파트,42106,3136,2111,3112,2111,24,174
한양2차아파트,37512,12640,4233,12462,4233,178,562
한양2차아파트,38055,5147,3759,5114,3759,33,296
한양2차아파트37동,38058,1497,1095,1489,1095,8,86
한양공구,39664,107,2,107,2,0,3
한양공구,39753,1,87,1,87,0,2
한양공구,42071,1012,7203,1008,7203,4,273
한양쇼핑,40331,1255,7769,1191,7769,64,300
한양쇼핑,40333,5471,3282,5406,3282,65,291
한양수자인,35450,2395,364,2344,364,51,91
한양수자인,42868,4231,2165,4156,2165,75,213
한양수자인,42893,3167,3208,2999,3208,168,212
한양수자인(후문),35537,3398,515,3337,515,61,130
한양아파트,37076,1971,6167,1928,6167,43,271
한양아파트,37079,5629,627,5570,627,59,208
한양아파트,40269,449,269,449,269,0,23
한양아파트,40310,15146,4716,14980,4716,166,662
한양아파트,40356,16402,10389,16273,10389,129,893
한양아파트,40905,40,442,40,442,0,16
한양아파트2차,38062,3423,6058,3387,6058,36,316
한양화학,42523,3190,762,3093,762,97,131
한일베라체,42839,5652,1135,5470,1135,182,226
한일베라체,42865,1316,2330,1265,2330,51,121
한일베라체,42948,3995,1683,3936,1683,59,189
한일아파트,41295,1102,2374,1097,2374,5,115
한일아파트,41296,2077,1095,1988,1095,89,105
한일아파트,80195,89,1397,88,1397,1,49
한일튜브(주),42576,332,291,330,291,2,20
한전사택,44090,22,34,22,34,0,1
한전사택,44197,1,0,1,0,0,0
한전온수출장소,43012,295,476,277,476,18,25
한주글로벌,89306,10,366,10,366,0,12
한진,38540,5,309,5,309,0,10
한진,38541,307,3,306,3,1,10
한진아파트,38016,25423,17349,25276,17349,147,1425
한진아파트,41355,248,502,241,502,7,25
한진아파트후문,41300,2767,586,2764,586,3,111
한풍산업,39014,473,695,461,695,12,38
한화2차,40363,3406,1482,3353,1482,53,162
한화꿈에그린,42860,1217,393,1182,393,35,53
한화꿈에그린,42872,324,1055,291,1055,33,45
한화꿈에그린정문,89372,2727,2076,2633,2076,94,160
한화아파트,40351,12803,8098,12597,8098,206,696
한화아파트,40379,2510,2069,2495,2069,15,152
한화아파트,40380,3991,2246,3930,2246,61,207
한화아파트,41375,4209,3166,4132,3166,77,245
한화지구공원앞,39654,1394,939,1394,939,0,77
한희빌딩,39311,1952,5446,1870,5446,82,246
함박도서관,38286,4156,2660,4101,2660,55,227
함박도서관,38742,287,1548,285,1548,2,61
함박마을,38277,5717,2217,5515,2217,202,264
함박마을문화복지센터,38291,3461,1777,3402,1777,59,174
함박마을문화복지센터,38741,267,1835,263,1835,4,70
함박마을입구,38285,2856,9066,2783,9066,73,397
함허동천,43352,3,52,3,52,0,1
함허동천,43403,111,9,108,9,3,4
합동청사역,35207,22380,4366,22172,4366,208,891
합정역,14220,213,11711,213,11711,0,397
합정역,23029,284,30554,284,30554,0,1027
합정역,23030,40314,632,40249,632,65,1364
항동7가버스차고지,35609,1186,29,783,29,403,40
항동7가버스차고지,35610,649,691,65,691,584,44
항동7가버스차고지(삼거리),35704,487,512,12,512,475,33
항동7가버스차고지(삼거리),35705,1035,10,904,10,131,34
항운아파트,35065,15793,3792,15490,3792,303,652
항운아파트,35481,1303,8258,1241,8258,62,318
항운아파트,35602,354,1898,351,1898,3,75
항진축산,39056,718,1844,718,1844,0,85
항진축산,39058,1853,910,1853,910,0,92
항청리종점,43558,148,117,132,117,16,8
항포,90247,0,5,0,5,0,0
항포,90248,21,1,21,1,0,0
해광병원,40292,92,2335,70,2335,22,80
해넘이마을,90135,26,15,26,15,0,1
해넘이마을,90136,49,31,48,31,1,2
해돋이공원,38008,27,192,27,192,0,7
해돋이공원,38010,445,681,445,681,0,37
해돋이공원,38718,26,55,26,55,0,2
해돋이도서관,38729,171,43,170,43,1,7
해돋이도서관,38730,9,517,9,517,0,17
해뜨는집앞,35531,6,29,6,29,0,1
해뜨는집앞,35726,63,4,63,4,0,2
해망,90352,1,8,0,8,1,0
해망,90353,14,0,13,0,1,0
해맞이공원앞,35616,260,497,254,497,6,25
해맞이공원앞,35617,352,219,347,219,5,19
해명초등학교앞,90179,10,19,10,19,0,0
해명초등학교앞,90180,27,148,27,148,0,5
해모로월드뷰,39794,1102,327,1087,327,15,47
해모로월드뷰,39805,494,771,484,771,10,42
해물탕거리,40782,3896,2170,3896,2170,0,202
해병2사단.향동,80054,921,638,909,638,12,51
해사고등학교,35503,1479,26,1441,26,38,50
해사고등학교.한국이민사박물관,35126,36,2306,36,2306,0,78
해서초등학교,41166,615,732,587,732,28,44
해서초등학교,41168,651,1363,628,1363,23,67
해성단조,42813,89,2,69,2,20,3
해송노인요양병원,35552,2,51,2,51,0,1
해송노인요양병원,35553,21,0,19,0,2,0
해수워터피아,42082,4433,702,4322,702,111,171
해수워터피아,42083,1500,7077,1482,7077,18,285
해안도로신항만교,39001,289,859,289,859,0,38
해안도로신항만교,39002,593,472,590,472,3,35
해암약수,90161,19,12,18,12,1,1
해암약수,90162,1,14,1,14,0,0
해양경찰청,38014,1024,3369,989,3369,35,146
해양경찰청,38015,6167,3146,6120,3146,47,310
해양경찰청,38411,8578,6573,8503,6573,75,505
해양기계,39532,23,40,22,40,1,2
해양기계,39696,2,162,2,162,0,5
해오름민박,43413,68,33,68,33,0,3
해오름민박,43442,34,63,34,63,0,3
해원고등학교,42964,15,647,14,647,1,22
해원중학교,42972,1563,58,1487,58,76,54
해원중학교,42973,61,748,57,748,4,26
해원중학교후문,42965,1453,501,1376,501,77,65
해피타운앞,44139,2,0,1,0,1,0
해피타운앞,44198,35,64,28,64,7,3
해피하임.기업은행앞,42738,18,1580,18,1580,0,53
핸즈코퍼레이션,89262,27,2215,17,2215,10,74
핸즈코퍼레이션,89263,11,55,5,55,6,2
햇내로공원입구,35777,46,11,46,11,0,1
햇내로공원입구,35784,0,26,0,26,0,0
행복마을입구,35687,28,7,26,7,2,1
행복마을입구,35690,17,95,16,95,1,3
행자골,43350,3,13,3,13,0,0
행자골,43583,14,3,12,3,2,0
행정복지센터사거리,40332,775,3039,775,3039,0,127
향나무골,43131,27,2,27,2,0,0
향나무골,43648,17,20,17,20,0,1
향동해병2사단,80055,843,1649,831,1649,12,83
향촌휴먼시아2단지,39741,8886,14911,8824,14911,62,793
허브주유소,35446,335,456,325,456,10,26
허브주유소,35447,460,5508,452,5508,8,198
허튼개,90119,3,16,3,16,0,0
허튼개,90120,32,4,30,4,2,1
헤나무,43199,3,30,3,30,0,1
헤나무,43317,40,4,39,4,1,1
혁이네슈퍼,40738,44,679,38,679,6,24
혁이네슈퍼,40739,359,49,320,49,39,13
현광아파트,37007,2089,10,2051,10,38,69
현광아파트,37488,13,2440,6,2440,7,81
현광아파트,39380,17071,17809,16894,17809,177,1162
현광아파트,41071,5606,1582,5522,1582,84,239
현광아파트,41432,3041,5919,3004,5919,37,298
현광아파트,42258,105,727,91,727,14,27
현광아파트,42260,613,178,595,178,18,26
현광아파트(호산부인과),39376,32591,16540,32223,16540,368,1637
현광아파트후문,37560,2809,12,2775,12,34,94
현광아파트후문앞,37559,164,1443,6,1443,158,53
현대.태화아파트,41402,288,3769,278,3769,10,135
현대102동,40146,2892,1210,2849,1210,43,136
현대121동,40137,5677,800,5595,800,82,215
현대1단지관리사무소,40740,260,2517,251,2517,9,92
현대1차아파트,38061,6653,3976,6533,3976,120,354
현대1차아파트,41365,9418,659,9341,659,77,335
현대1차아파트정문,41367,110,338,104,338,6,14
현대207동,40168,645,10168,622,10168,23,360
현대209동,40167,10523,654,10377,654,146,372
현대2차아파트,38173,2062,2849,2032,2849,30,163
현대2차아파트,41106,823,4070,812,4070,11,163
현대2차아파트,41112,8182,585,8040,585,142,292
현대2차아파트,41366,488,5661,472,5661,16,204
현대2차아파트정문,41364,396,6265,387,6265,9,222
현대310동(서중학교),40097,992,2690,949,2690,43,122
현대3단지,40127,7606,6479,7523,6479,83,469
현대3단지,40129,7836,8792,7736,8792,100,554
현대3차아파트,38168,17395,11143,16840,11143,555,951
현대3차아파트,38342,18001,16578,17579,16578,422,1152
현대4차아파트,38158,2049,2074,2018,2074,31,137
현대4차아파트,38183,2605,3945,2530,3945,75,218
현대4차아파트,38186,3759,1389,3681,1389,78,171
현대5차,40405,11244,6214,11055,6214,189,581
현대5차,40408,6544,4531,6468,4531,76,369
현대5차아파트,38176,3955,1671,3794,1671,161,187
현대동부시장,36041,11838,5694,11384,5694,454,584
현대모닝.임광그대가아파트,39579,7562,2965,7487,2965,75,350
현대백화점,22003,5312,56,5310,56,2,178
현대슈퍼,43376,212,16,200,16,12,7
현대슈퍼,43617,12,79,12,79,0,3
현대시장,36042,10585,6353,10326,6353,259,564
현대시장,36043,7175,8919,6914,8919,261,536
현대시장,36118,7085,9526,6934,9526,151,553
현대써비스,42021,3926,2904,3904,2904,22,227
현대아파트,35396,204,15,203,15,1,7
현대아파트,37154,3006,8396,2978,8396,28,380
현대아파트,37161,7679,3527,7564,3527,115,373
현대아파트,39267,5973,5403,5851,5403,122,379
현대아파트,39271,6017,3350,5925,3350,92,312
현대아파트,40112,38278,26795,37819,26795,459,2169
현대아파트,40681,2197,7288,2151,7288,46,316
현대아파트,40682,8259,1787,8184,1787,75,334
현대아파트,40737,1172,2393,1156,2393,16,118
현대아파트,40788,37995,34736,37706,34736,289,2424
현대아파트,43082,52,460,52,460,0,17
현대아파트,43083,385,94,377,94,8,15
현대아파트.통진도서관,80135,180,1196,177,1196,3,45
현대아파트.통진도서관,80136,1216,189,1197,189,19,46
현대아파트105동,40734,171,1017,164,1017,7,39
현대아파트105동,40735,820,339,808,339,12,38
현대아파트113동,40105,10030,5978,9891,5978,139,533
현대아파트116동,40732,1732,412,1710,412,22,71
현대아파트119동,40733,111,2483,108,2483,3,86
현대아파트120동앞,40140,403,5042,387,5042,16,181
현대오일뱅크,41459,1601,990,1584,990,17,86
현대자동차빌딩앞,40103,6320,12795,6204,12795,116,637
현대자동차서비스,42032,9228,2394,9176,2394,52,387
현대자동차서비스,42033,12677,8354,12616,8354,61,701
현대제철,36086,637,1113,619,1113,18,58
현대제철,36123,2942,764,2914,764,28,123
현대제철정문,36133,530,1242,501,1242,29,59
현대철강레이져,90220,0,5,0,5,0,0
현대철강레이져,90221,16,0,16,0,0,0
현송중학교,38744,1069,312,1053,312,16,46
현송중학교,38745,540,940,530,940,10,49
형제마트,40004,616,1986,604,1986,12,86
형제마트,40006,1927,620,1904,620,23,84
혜덕,90217,8,2,8,2,0,0
혜성프라자,40393,24546,13632,24231,13632,315,1272
혜성프라자,40395,15557,17764,15311,17764,246,1110
호구포역,39784,6140,7272,6113,7272,27,447
호구포역,39785,9869,8233,9843,8233,26,603
호구포역2번출구,92040,1346,421,1335,421,11,58
호명사입구,40093,10,471,3,471,7,16
호박골,43437,31,44,30,44,1,2
호박골,43784,68,18,61,18,7,2
호박골사거리,43123,4,50,4,50,0,1
호박골사거리,43124,31,11,26,11,5,1
호박골사거리,43706,9,207,9,207,0,7
호박골사거리,43804,75,9,71,9,4,2
호반베르디움,42855,442,4825,428,4825,14,175
호반베르디움14단지,42880,1011,4200,930,4200,81,173
호반베르디움214동앞,42998,150,700,141,700,9,28
호반베르디움2차,89112,1664,1374,1655,1374,9,101
호반베르디움2차,89113,1307,1372,1294,1372,13,89
호반베르디움3차아파트,42743,2741,7168,2701,7168,40,330
호반베르디움3차아파트,42908,1270,4879,1232,4879,38,204
호반베르디움아파트,39922,2466,1661,2450,1661,16,137
호반베르디움아파트107동,92011,2927,128,2921,128,6,101
호반써밋1차 3101동,89393,807,2139,801,2139,6,98
호반써밋1차 3101동,89394,1465,279,1436,279,29,58
호반써밋1차아파트,89472,20,63,18,63,2,2
호반써밋1차아파트,89473,49,208,49,208,0,8
호반써밋송도,38637,3358,137,3333,137,25,116
호반써밋송도(109동),38634,141,337,139,337,2,15
호불사입구,38180,2395,3284,2330,3284,65,189
호불사입구,38182,3116,1709,3061,1709,55,160
호세요양원,43221,43,104,41,104,2,4
호세요양원,43311,3,9,3,9,0,0
호수공원,89103,199,747,199,747,0,31
호수공원,89104,2397,848,2380,848,17,108
호수공원음악분수,89027,1763,1118,1732,1118,31,96
호수공원음악분수,89028,917,1939,890,1939,27,95
호수마을5단지후문,35270,30,57,30,57,0,2
호수마을5단지후문,35735,59,84,59,84,0,4
호수마을이편한세상.한가람우미린,80319,1144,445,1107,445,37,52
홈씨씨인천점,89188,288,710,284,710,4,33
홈플러스,80070,276,2979,271,2979,5,108
홈플러스,89225,495,369,487,369,8,28
홈플러스,35218,223,1281,217,1281,6,50
홈플러스.산림조합,80018,3315,169,3312,169,3,116
홈플러스계산점,41622,36,1415,36,1415,0,48
홍대입구역,23011,183,7189,179,7189,4,245
홍대입구역,23031,46132,598,46055,598,77,1557
홍대입구역,23032,386,20159,383,20159,3,684
홍예문·공영주차장,35794,12,455,12,455,0,15
홍예문·공영주차장,35806,100,629,96,629,4,24
홍의사거리,43798,42,40,40,40,2,2
홍의사거리,43813,11,10,5,10,6,0
홍의삼거리,43441,13,37,13,37,0,1
홍의삼거리,43613,56,32,51,32,5,2
홍익자원,35514,1233,583,1213,583,20,60
홍익자원,35515,60,982,55,982,5,34
홍현마을,90002,35,6,34,6,1,1
홍현마을,90003,9,36,5,36,4,1
화개사입구,90034,1,69,1,69,0,2
화개사입구,90035,69,1,69,1,0,2
화개정원,90405,5,54,5,54,0,1
화곡역,16147,174,36958,174,36958,0,1237
화곡역,25190,34352,92,34263,92,89,1148
화도,43077,56,128,48,128,8,6
화도고개,36027,2148,2776,2073,2776,75,164
화도고개,36028,1720,5008,1666,5008,54,224
화도돈대,43676,48,1,46,1,2,1
화도돈대,43863,0,43,0,43,0,1
화도진공원.화도진도서관,36033,11870,3803,11672,3803,198,522
화도진공원.화도진도서관,36035,4103,11658,3998,11658,105,525
화도진중학교,36064,3390,674,3250,674,140,135
화도진중학교,36066,1000,3015,909,3015,91,133
화도터미널,43104,1116,1500,1030,1500,86,87
화도터미널,43105,1536,853,1463,853,73,79
화력발전소,42628,285,336,285,336,0,20
화문석문화관,43697,134,2,125,2,9,4
화물터미널,35039,7,217,7,217,0,7
화물터미널,35040,201,22,200,22,1,7
화성보일러,39107,2687,5669,2668,5669,19,278
화성파크드림.스카이시티자이,35651,6026,2084,5949,2084,77,270
화성파크드림후문.한라비발디,35659,611,1023,592,1023,19,54
화수부두,36147,671,1113,625,1113,46,59
화수사거리,36072,2647,793,2556,793,91,114
화수사거리,36104,368,1497,349,1497,19,62
화전초교사거리,41087,981,1204,974,1204,7,72
화전초등학교,41085,1216,558,1214,558,2,59
화전초등학교,41086,566,514,566,514,0,36
화평철교.화평동냉면거리,36014,2736,3153,2681,3153,55,196
화평철교.화평동냉면거리,36016,15956,20897,15549,20897,407,1228
화훼단지·당미교,41462,118,351,111,351,7,15
화훼단지·당미교,41463,136,167,136,167,0,10
환경공단강화사업소,90109,0,5,0,5,0,0
환경공단강화사업소,90110,2,0,1,0,1,0
황곡노인정,89310,84,0,71,0,13,2
황곡노인정,89320,65,128,51,128,14,6
황곡상회,89311,40,1,38,1,2,1
황곡상회,89330,2,47,2,47,0,1
황골,43992,10,31,7,31,3,1
황골,43993,55,4,51,4,4,1
황골마을,43135,8,15,8,15,0,0
황골마을,43277,35,4,35,4,0,1
황련사입구,43328,91,53,87,53,4,4
황련사입구,43630,24,0,24,0,0,0
황산도,43635,10,41,7,41,3,1
황산도관광밸트,43873,4,2,4,2,0,0
황산도관광밸트,43876,3,4,3,4,0,0
황산도입구,43636,42,7,41,7,1,1
황산도입구,43861,20,12,20,12,0,1
효성2동치안센터,41024,1934,9129,1873,9129,61,368
효성고등학교,41074,2013,737,1969,737,44,91
효성고등학교,41075,680,2593,666,2593,14,109
효성남초등학교,41040,6029,3099,5963,3099,66,304
효성노인문화센터,41409,597,1833,594,1833,3,81
효성노인문화센터,41410,541,826,541,826,0,45
효성농협,41039,2689,1495,2620,1495,69,139
효성뉴서울아파트,41060,13372,1775,13239,1775,133,504
효성뉴서울아파트,41061,2431,13473,2331,13473,100,530
효성뉴서울아파트202동,41078,1436,17284,1388,17284,48,624
효성뉴서울아파트204동,41368,15428,1756,15313,1756,115,572
효성대신아파트,41041,5723,2787,5598,2787,125,283
효성대신아파트,41042,466,3782,428,3782,38,141
효성도서관,41420,2123,409,2107,409,16,84
효성동동화운수차고지,41573,12241,4149,11893,4149,348,546
효성명현초등학교,41065,3984,913,3869,913,115,163
효성사거리,41017,1548,4976,1480,4976,68,217
효성사거리,41018,12210,4386,11989,4386,221,553
효성사거리,41019,4885,6838,4765,6838,120,390
효성사거리,41631,806,712,781,712,25,50
효성상아아파트,39357,13815,16453,13610,16453,205,1008
효성상아아파트,39358,18801,13338,18565,13338,236,1071
효성서초등학교,41557,2833,443,2816,443,17,109
효성서초등학교,41558,361,2380,361,2380,0,91
효성서초등학교,41579,214,1010,214,1010,0,40
효성서초등학교,41580,1702,595,1702,595,0,76
효성성모병원,41022,5853,240,5793,240,60,203
효성소방파출소,41023,8676,2900,8567,2900,109,385
효성신사거리,41030,1819,7687,1742,7687,77,316
효성신사거리,41031,7311,1567,7168,1567,143,295
효성아파트,42166,10092,2611,9952,2611,140,423
효성아파트,42168,2565,8238,2527,8238,38,360
효성중앙교회,41021,165,7266,151,7266,14,247
효성프라자,41052,9142,8400,8980,8400,162,584
효성프라자,41055,6758,5279,6600,5279,158,401
효성현대3차,41049,1440,3309,1385,3309,55,158
효성현대3차아파트,41051,1029,577,1000,577,29,53
효성현대4차,41035,2711,4722,2578,4722,133,247
효성현대4차아파트,41036,5047,2135,4959,2135,88,239
효자교앞,90199,5,1,5,1,0,0
효자교앞,90200,2,1,2,1,0,0
효정아파트,38260,1080,1704,1072,1704,8,92
후정초등학교.삼산도서관,40685,70,1198,57,1198,13,42
후지테크,39051,2138,1328,2132,1328,6,115
후지테크,39052,477,1910,475,1910,2,79
후포항입구,43431,10,100,7,100,3,3
후포항입구,43481,62,5,53,5,9,2
휴먼시아1단지,40837,3696,6269,3622,6269,74,332
휴먼시아1단지,40838,6248,2463,6141,2463,107,290
휴먼시아1단지,40840,1010,12,997,12,13,34
휴먼시아1단지,40852,326,1813,271,1813,55,71
휴먼시아후문,42885,9609,3810,9405,3810,204,447
흥성리,18804,4,206,4,206,0,7
흥성리,62029,198,7,198,7,0,6
흥왕2리마을회관 앞,43122,33,37,32,37,1,2
흥왕2리마을회관 앞,43520,54,32,52,32,2,2
흥왕리,90073,1,16,1,16,0,0
흥왕리,90074,17,14,15,14,2,1
흥왕상회,43502,22,10,21,10,1,1
흥왕상회,43516,19,9,19,9,0,0
희경산업·남동스카이장례식장,39031,191,88,189,88,2,9
희경산업·남동스카이장례식장,39961,18,226,18,226,0,8
희망찬요양병원,38126,3921,6527,3848,6527,73,348
희망천입구,40091,5356,4694,5266,4694,90,335
희망천입구,40799,5956,5570,5884,5570,72,384
희망체육공원입구,40912,5852,68,5615,68,237,197
희성금속,42018,142,576,136,576,6,23
힐데스하임,42876,9752,2653,9641,2653,111,413
힐스테이트,35457,14995,9460,14800,9460,195,815
힐스테이트,35458,5605,4820,5477,4820,128,347
힐스테이트레이크송도(후문),38630,2151,1603,2142,1603,9,125
힐스테이트레이크송도(후문),38656,2117,1455,2101,1455,16,119
힐스테이트레이크송도1차입구,38655,969,1279,956,1279,13,74
힐스테이트레이크송도1차입구,38751,6,210,6,210,0,7
힐스테이트레이크송도2차(201동),38641,1519,1979,1510,1979,9,116
힐스테이트레이크송도2차(201동),38657,1695,675,1684,675,11,79
힐스테이트송도더테라스(정문),38715,988,249,971,249,17,41
힐스테이트송도더테라스(정문),38716,193,607,188,607,5,26
힐스테이트송도더테라스(후문),38713,2466,2181,2383,2181,83,154
힐스테이트송도더테라스(후문),38714,735,2060,669,2060,66,93
힐스테이트푸르지오주안,37293,20861,31027,20535,31027,326,1729
힐스테이트학익,37022,5340,4079,5221,4079,119,313
힐스테이트학익,37023,3916,7339,3866,7339,50,375
힐스테이트학익104동앞,37669,834,1693,811,1693,23,84
힐스테이트학익104동앞,37670,1781,4482,1749,4482,32,208
힐캐슬프라자,39329,10669,15269,10502,15269,167,864
힐캐슬프라자,39331,16539,8669,16195,8669,344,840
힘찬병원,40891,5178,6917,5118,6917,60,403
힘찬병원,40892,4027,3057,3975,3057,52,236
